We now turn to the hostile nation of North Korea.	﻿ 我們 現在 關注 下 敵 對 國北韓 的 情況
The rocket they are testing is believed to be big enough	他們 正在 測試 的 導彈 被 認為
to reach the West Coast of the United States.	可以 直射 美國 的 西海岸
Today, an official of the United Nations	今天 聯合國 的 一位 官員
tried to tell the world... so there will be no mistake...	想 告訴 全世界 沒錯
that we are living in the midst of a modern-day Hitler.	我們 正 生活 在 現代 希特勒 的 陰霾 之下
A young, untested leader with nuclear ambition.	一位 年 輕 的 還未 經受 考驗 卻 有 著 核武器 雄心 壯志 的 領袖
- Kim Jong-un. -Kim Jong-un.	- 金正恩 - 金正恩
We are talking about Kim Jong-un.	我們 所 說 的 就是 金正恩
Good evening.	晚上 好
I'm Dave Skylark.	我 是 戴夫 • 史開勒 ( DaveSkylark , ” Skylark ” 意 同 「 胡鬧 」 )
Tonight, we are joined by 13-time Grammy winner,	今晚 我們 有幸 邀請 了 13 次格萊美獎
Oscar-winning songwriter,	以及 奧斯卡 作曲 獎的 獲得者
Detroit's own Eminem.	來 自 底特律 的 饒 舌 歌手 阿姆
He'll speak with us about his new album,	他 將會 跟 我們 分享 他 的 新 專輯
which has been mired in controversy	該 專輯備 受爭議
concerning lyrics that some view as demeaning to the elderly.	主要 由 於 歌詞 中 存在 一些 侮辱 老年人 的 內容
Tonight...	今晚
on "Skylark Tonight."	鎖定 " 今晚 史開勒 "
And... action.	好開 拍
"It's hell to be Shady.	" 當個 壞 人 真是 生不如死
Yesterday I yelled a degrading insult	昨天 我 對 著 一個 老 女人
At an elderly lady.	罵 幾 句 髒 話
Then I asked her how it felt to be 80.	接著 我問 她 80 歲 的 感覺 怎樣
F' word a senior citizen.	去 她媽 的 老人
Suck a wiener, sit and spin."	舔 棒子 坐著 吹 "
"Suck a wiener, sit and spin."	" 舔 棒子 坐著 吹 "
It's funny.	真 搞笑
"And why you drive so slow for?	" 那 你 為何 還開 這麼 慢
Don't you want to get where you're going faster	難道 你 不想 快點 到 達 你 想 去 的 地方
Since you'll probably die tomorrow, you old whore?	知不知道 你 可能 明天 就會掛 掉 老 婊子
Die, old bitch, die,	去死吧 老 婊子 去死吧
before I murder you."	在 我 殺 了 妳 前 死 吧 "
What do you mean by this, Em?	這是 什麼 意思 啊 阿姆
Well, first of all, I feel like, when I rap,	呃 首先 我覺 得 我 說 rap 的 時候
like, people twist my words.	好像 大家 會 曲解 我 的 歌詞
Okay, but can you see	好 吧 但 你 可以 想 看看
how an old person might say, "I think	老年人 聽到 了 可能 會 這麼 說 " 我覺 得
What this guy is telling me... this Eminem... is that I should	這個 叫 阿姆 的 傢 伙想 告訴 我 我 應該 自殺
go kill myself, and I... you know, I don't like that."	但 我 不 喜歡 這樣 "
I mean, I don't	我 的 意思 是
necessarily rap about the things that I hate.	我 唱 的 不 一定 是 我 討厭 的 內容
It's more about... the things that I fear.	我 唱 的 更 多 是 我 害怕 的 事
- I get you. -You know, it's like,	- 我 懂 了 - 你 懂 嗎 就 像是
- if I say something about women or whatever... -Yes.	- 如果 我 說關 於 女人 或 有 的 沒 的 - 嗯
I think a lot of that is more or less me	我覺 得 大多 數歌 詞
just dealing with issues with...	多多少少 是 我 在 化解 一些 心結
you know, old issues with my mom or whatever.	你 知道 的 一些 跟 我 媽媽 或是 其他 什麼 的 問題
With your "Mutha."	跟 你 的 母親 大人
Yeah, or-or... you know,	嗯 是 或 或者
when I say things about gay people	當我 說 起 同性 戀
or people think that my lyrics are homophobic,	或者 人們 認為 我 的 歌詞 是 反 同性 戀
- Mm-hmm. -you know, it's because I'm gay.	- 嗯 哼 - 其實 那 是 因為 我 是 個 同性 戀
Um, when I rap about violence	呃當 我 說 唱 與 暴力 有關 的 歌 詞時
- Wait... -or, you know, sound like I'm promoting violence,	- 等 下 - 或者 聽起 來 像 我 在 提倡 暴力
I think that, uh... you know,	- 我 認為 呃 你 知道
- it's more or less because... -What? -What, what, what?	- 這 或多或少 是 因為 - 什麼 - 什麼 什麼
you know, it's kind of... it's kind of about me just,	你 知道 這有點 像是 我 只是 在
you know, confronting it.	你 知道 的 面 對 它
- What did he just say? -Wait, can we play that...?	- 他 剛剛 說 了 什麼 - 等等 可以 回放 那段 嗎
- He said he was gay. -Did he just...? Dave? Dave?	- 他 說 他 是 同性 戀 ! - 他 剛剛 是不是 戴夫 戴夫
- Did he just say he was gay? -We're pretty sure	- 他 剛剛 是不是 說 了 他 是 同性 戀 - 我們 非常 確定
in the booth we just heard him say he was gay.	我們 剛剛 在 這邊 聽 到 他 說 他 是 同性 戀
Em, let's just... back it up a moment.	呃 先回到 前面 一點
You... just said	你 … 剛是 說
that you were gay?	你 是 同性 戀 嗎
Um... and I'm just curious	啊 我 只是 很 好奇
what you meant by that exactly.	你 那麼 說 想表達 的 真正 意思 是 什麼
I mean I'm gay.	意思 是 我 是 同性 戀
Uh, I'm just a little confused here, because "Gay"	呃 我 有點 不 明白 因為 " 同性 戀 ( gay ) "
can mean a lot of things.	有 很多 種 意思
I am a homosexual.	我 是 同性 戀者
Meaning...?	意思 是
I like men.	我 喜歡 男人
What the fuck just happened?	幹剛剛 他媽 的 發生 什麼 事
Eminem just said he was gay... four times.	艾米 納姆 剛剛 說 了 他 是 同性 戀 四次
That's what the fuck just happened.	這 就是 剛剛 的 他媽 的 事
- Holy shit. -Holy shit.	- 喔 幹 – 喔 幹
Eminem's gay on our show.	阿姆 在 我們 的 節目裡 說 他 是 同性 戀
- Eminem's gay on our show! -Oh, my God!	- 阿姆 在 我們 的 節目裡 說 他 是 同性 戀 – 喔 天 啊
Camera two! Camera two!	二號 攝影 機二號 攝影機
Gay Twitter! Gay Twitter's blowing up.	同性 戀 的 推特圈 同性 戀 的 推特圈 要 爆 了
- Holy shit. -Change the chyron.	- 屌 爆 了 - 快換 字幕
"Eminem Gay?!" Question mark, exclamation mark.	" 阿姆 是 同性 戀 " 加上 問號 驚嘆號
Dave, keep him talking. Keep him talking.	戴夫 讓 他 繼續 講讓 他 繼續講
- Oh, my God. -Holy shit. Push in on gay Eminem!	- 天 啊 - 幹 阿姆 的 出櫃 時刻
This is the greatest moment in gay history!	這 真是 同性 戀史 上 最具 歷史性 的 時刻
are probably shocked by what you're saying right now.	人們 很 可能 已經 被 你 剛剛 所 說 的 震 驚 了
I'm more shocked that people haven't figured it out yet.	我 更 震 驚 的 是 大家 到現 在 都 還沒 發現
I mean, it's kind of like I've been playing gay peekaboo.	我 的 意思 是 搞 得 好像 我 在 玩 同性 戀 躲 貓貓 一樣
Gay peekaboo.	同性 戀 躲 貓貓
Yeah. But, um...	是 啊 不過 啊
Shit. Camera one. Camera one.	靠 一號 攝影機 一號 攝影機
- This interview is over. Shut it off. -No!	- 這次 訪談 結束 了 關掉 - 不要
- Shut it off. -Get the fuck out of here, Darryl.	- 快關 掉 - 達瑞爾 你 他 媽給 我 滾
I am Marshall's publicist, and I'm telling you,	我 是 馬 歇爾 發言人 我 說 的 算
- pull the fucking plug right now. -No. This is gold.	- 馬 上 把 那 該 死 的 插頭 拔掉 - 不要 這新聞 是 寶藏
I am not cutting this interview off.	我 才 不會 把 訪談 中斷
This is the best interview we've ever done.	這是 我們 有史 以來 做過 最好 的 訪談
- What happens if I just do this? -No, get out.	- 那 如果 我 這麼 做會 怎樣 - 不要 滾 出去
Shut it off! Shut it off!	關掉 它 關掉 它
Get him out of here! Get him the fuck out of here!	把 他 弄 出 這裡 快 他媽 的 把 他 弄出去
I will murder you and everyone you love!	我會 宰 了 你 還有 你 愛的 人
Thank you. Dave, look, I got the lyrics.	謝謝 你 戴夫 聽 著 我 拿到 歌詞 了
Say what I say:	照著 我 說 的 問他
What did you mean when you rapped...	當你說 唱 這句 歌詞 的 時候 想表達 什麼
"I said nice rectum, I had a..."	" 我 說 真是 朵 漂亮 的 菊花 我 做 了
"...vasectomy, Hector.	結 扎手 術 啊 赫克托
So you can't get pregnant	如果 我 的 雙性 戀毀 了 你
if I bisexually wreck ya."	你 也 不會 懷孕 了 "
I've pretty much just been leaving a...	我 很 明確 地 留下 了
bread-crumb trail of gayness.	「 我 是 同性 戀 」 的 暗示
- I see that now. -You know.	- 我現 在 看到 了 - 你 知道
But yeah, actually Hector...	的 確實際 上 赫克托
Hector was a... was a real person.	赫克托 是 一個 一個 真實 存在 的 人
Hector and his rectum were real?	赫克托 和 他 的 菊花 是 真的 嗎
- Holy shit. -It's real! Hector rectum is real!	- 我操 - 這是 真的 耶 赫克托 和 他 的 菊花 是 真的
- Yes! Yes! -Oh, I knew it! -Slim Shady, everyone!	- 太好了 - 噢 我 就 知道 - 各位
Dude! Dude!	兄弟 兄弟
Aaron, bring it in.	艾倫超 屌 的
- Oh, my God. Oh, my God. -Bring it in, big boy!	- 噢 我 的 天 我 的 天 啊 – 老兄 屌 爆 了
Oh, my God...	噢 我 的 天 啊
- Oh...! -Oh, my God!	- 噢 - 我 的 天 啊
What the heck just happened?	剛才 他媽 的 發生 什麼 了
The real Slim Shady just stood up.	真實 的 阿姆 出櫃 了
- Oh! -That's what the fuck just happened.	- 哦 - 那 就是 剛才 發生 的
This is like Spike Lee just said he's white.	這就 像是 史 派克 • 李說 他 是 白人
I can't believe what's happened.	我 簡直 不敢相信 剛剛 發生 的 事
- You da man! You da man! -You da man!	- 你 太 屌 了 太 屌 了 - 太 屌 了
You're the best.	你 是 最 屌 的
You're the best. You're the best.	你 最 屌 了 你 最 屌 了
- Unreal. -All right, listen, I'm gonna go get my makeup off.	- 不敢相信 - 好 吧 聽 著 我 先去 卸妝
I want you to meet me downstairs.	一會樓 下 見
I got something to show you.	有 東西 要給 你 看
Dude, just... where are we going?	老兄 只是 我們 要 去 哪兒 啊
I thought we were going to the Hamptons for the weekend, man.	我 還以 為 我們 周末 要 去 漢普頓斯 度假 呢
- No, no, no, no, no, no... -What is this place?	- 不 不 不 不 - 這是 哪兒
We're just, you know... just hanging out.	我們 只是 你 懂 的 只是 一起 出去玩
- Okay. -All right, all right, all right.	- 哦 - 好 吧 好 吧
It's a surprise party... for you.	有場 為 你 準備 的 驚 喜派 對
What? Why? Why did you just tell me that?	什麼 為 啥 你 為 啥 要 告訴 我
Yes! I... 'Cause I'm so excited.	因為 我 太 激動 了
This is gonna be great. This is gonna be great.	這 一定 會 很棒 這 一定 會 很棒
I don't understand what's happening.	我 不 懂現 在 是 什麼 情況
Surprise!	驚喜
All right, all right. I already told him.	好 吧 好 吧 我 已經 告訴 他 了
I already told him. Come on, come on.	我 已經 告訴 他 了 快 來 快 來
You're best in the world, you fucking cocksucker.	你 是 全宇宙 最棒 的 你 個 混蛋
All right, not now, Malcolm. Not now, not now. Come on.	好 吧 不是 現在馬爾 科姆 不是 現在 借過
- Come on. -Thank you. Why... why is this happening?	- 借過 - 謝謝現 在 什麼 情況
You've been with us	你 和 我們 在 一起 製 作 了
for 1,000 episodes.	1000 集 了 啊
- Are you kidding me? -Ten years, baby!	- 你 沒騙 我 吧 - 10 年 啦 哥們 兒
- Are you fucking... -Come on.	- 他媽 是 真 .. - 來 吧
I really do. It's, uh... I appreciate it.	我 真的 是 嗯 我 太 感激 你們 了
- All right. -Okay.	- 好 了 - 好 吧
All right, now,	好 了 現 在 都 聽 我 說
I know I like to keep it light, keep it fun.	我 想 把 氣氛 維持 輕 鬆 好玩
I'm gonna take it to a serious tip.	但是 我現 在 要 認真講 一段 話
I'm gonna talk about Aaron.	我要 說 說 艾倫
Before we started working together,	在 和 艾倫 一起 工作 之前
my show barely broke the top 15.	我 的 節目 收視率 只有 在 前 15 邊緣
So I called up this professor that worked	所以 為 此 我 找 了 一個 跟 我 上 過床 的
at the Columbia School of Journalism that I...	哥倫比亞 新聞 學院 的 教授
I was having sex with, and I said,	然後我 說
"I need someone smarter than anyone in entertainment.	" 我 需要 一個 娛樂 圈裡 最聰明 的 人
I need a real journalist."	一個 真正 的 記著 "
Aaron, you are the Samwise Gamgee	艾倫 我 是 佛羅多
to my Frodo Baggins.	你 就是 我 的 山姆
You are the Gandalf to my Bilbo Baggins.	我 是 比爾博 你 就是 我 的 甘道夫
But of all the Lord of the Rings references that I could make,	但是 整個 《 魔戒 》 的 故事 中 我 能 想到 的 比喻
this is the most important:	以下 才 是 最 重要 的 :
I'm Gollum...	我 是 咕嚕
and you're my precious.	而 你 就是 我 的 珍寶
Smeagol needs Aaron.	史麥戈 ( 咕魯 本名 ) 需要 艾倫
"One Ring to rule them all,	" 至尊 魔戒 統治 世界
and in the darkness bind them."	將 世界 蒙蔽 在 黑暗 中 "
Now, get up here! Get up here!	現在 快 上 臺 到 這來
- Come up here, buddy. I love you. -Okay. Okay. Okay.	- 到 這來 兄弟 我愛死 你 了 - 好 了 好 了 我 知道
- I fucking love you. -Oh...	- 我 他 媽愛死 你 了 - 哦 ..
Hey.	嘿
Hey!	嘿
Hey.	嘿
Yeah. Like, what's that?	喂 看看 那 是 誰 啊
Come on, man. What's happening?	嘿 老弟 你 怎麼 會 在 這
- Hey, yeah. -Hey, yeah.	- 嘿 - 嘿
- Wh-What's happening? -How's it going, dude?	- 你 你 怎麼 也 在 這 - 最近 怎麼樣 兄弟
We haven't seen each other since graduation, right?	我們 自打 畢業 後 就 再 沒見過 對 吧
- Yeah. Probably. -Wow. And, uh...	- 是 吧 好像 是 - 喔 那個
Wait. Am I wrong? Are you, like, a...	等 一下 我 沒 搞 錯 吧 你 是 那個
you're a junior producer on "60 Minutes," Right?	" 60 分鐘 時事 新聞 " 的 初 級 製 片 人 對 吧
I'm now a senior producer.	我現 在 是 高 級 製 片 人
- No way, man. -Yeah. Yeah.	- 不會 吧 - 千真 萬確
- That's awesome. -Thank you.	- 你 太 厲害 了 - 謝謝
Look at us... both producing news for television.	看看 我們 都 在 做 電視 新聞 節目
Yeah.	算是 吧
- What was that? -Nothing.	- 怎麼 了 - 沒事 啦
It was clearly something. What's the joke?	看起 來 就 有 點事 怎麼 了
No, I mean, like, you've got your job,	沒 我 只是 想 說 你 有 你 的 工作
I got mine, but they're different, you know?	我 有 我 的 但是 工作 類型 不 太 一樣 你 明白 麼
Yours is cool; mine's just	你 的 很酷 但 我 的
a little bit more serious, you know?	更 嚴肅 一點 你 懂麼
What are you saying? We have the same job.	你 到底 在 說 什麼 我們 的 工作 是 一樣 的
I report real news... you know, stuff that matters...	我 報道 貨真 價實 的 新聞 你 要 知道 那些 關乎 民生 的 新聞
and then you report on all the cool	而 你則 是 報道 那些 八卦 消息
"Who's getting new boobs" And, like,	比如 " 誰 又 隆乳 了 "
the fun eating disorder stuff.	還有 可笑 的 厭 食症 等 雜七雜 八 的 事情
You really helped build up "60 Minutes," Too, right?	你 也 真的 是 在 做 " 60 分鐘 時事 新聞 " 對 吧
They'd be nothing without you.	如果 沒有 你 他們 一無是 處
It's only been on for 80 fucking years.	這節 目才 僅僅 播出 他媽 80 年
Look, I... I'm sorry.	哦 對 對 不起
I'm sorry... look... I shouldn't say this,	對 不起 我 想 我 不該 那麼 說
but we got an opening over at "60 Minutes,"	但 我們 的 新聞 節目 正在 徵人
and we could use somebody like you.	也許 我們 會 用 得 著 像 你 這樣 的 人才
Are you serious?	真的 麼
I'm fucking with you, man. Come on! You?	我 在 耍 你 啦 得了吧 你 要 來 ?
At where I work? You'd be eaten alive at our office.	在 我 那 工作 你 在 我們 那會 生吞 活剝 的
Okay, I'm gonna catch up with these guys,	好 了 我 要 回去 了
but cheers, man.	但 無論 如何 乾杯
Congrats... or whatever.	不管 怎麼樣 恭喜 了
When did the hair begin to go?	頭 髮 什麼 時候 開始 掉 的
I would say... -	我 想
around "The Outsiders."	大概 是 在 拍 " 小教父 " 那個 時候
When you're ready.	當你 準備 好 了 就
I don't think I'll ever be ready, but...	我 不 認為 我 曾 準備 好 了 但是 今天
- Oh, wig's coming off. -Oh.	- 哦 要 摘掉 假 髮 了 - 哦
Whoa.	哇
Oh, Jesus fuck.	哦 天 啊 幹
Why does he keep the long pieces?	為 什麼 他 還留 著 那麼 幾 撮 毛
His head looks like somebody's taint.	他 的 腦袋 就 像是 得 了 性病
- You barely look different. -Thanks, man.	- 你 幾乎 沒變 - 謝謝
You... you said you were bald.	你 你 說過 你 全禿 了
I... I see a little stuff on top.	但 但 我還 看到 有 幾根 在 你 頭頂 上 呢
- It's so freeing! -Rob...	- 這太 舒服 了 - 羅 伯
is there anything that you would like to say to America?	你 有 什麼 想 對 美國 人民 說 的 麼
Good evening.	晚上 好
I'm Phillip Sterling	我 是 菲利普 • 斯特林
with a UBS News Special Report.	給 大家 帶來 UBS 新聞 特別 報道
Whoa, whoa, whoa.	喔 喔 喔
Kim Jong-un's military forces	北 韓軍隊
targeted an uninhabited South Pacific island	向位 於 南太平洋 的 一個 無人小島
with a 15-megaton thermonuclear ICBM.	發射 了 一枚 15 兆噸 的熱 核武器 洲際導彈
Yo, Dave, we're not live anymore.	戴夫 我們 不能 直播 了
- They just cut our feed. -We're off the air?	- 他們 把 我們 中斷 了 - 我們 斷線 了 麼
Goddamn it! Rob, would you just put your fucking wig on?	真該 死羅伯 你 能 把 你 那 該 死 的 假 髮 戴 上 嗎
They fucked us! Goddamn it!	他們 搞 死 我們 幹 你媽 的
Somebody tell me what's going on?	有 誰 能 告訴 我 到底 發生 了 什麼
Dude... seriously, what is up with you?	老兄 說 真的 你 到底 怎麼 了
You know how I'm good at picking up energies?	你 知道 我 渾身 充滿 了 正 能量 的
Well, you're shooting off a slightly cunty vibe right now.	好 了 你 快點 把 你 這張 的 屎 臉 臉 收回 去
What's going on?	到底 怎麼 了
We have millions of viewers every night	我們 有 上百 萬 的 觀眾
watching our show, and what do we do?	每天晚上 看 我們 的 節目 而 我們 卻 做 了 什麼
We just shovel shit into their faces, man.	我們 簡直 是 挖 屎給 他們 吃
We could be doing something positive.	我們 可以 做 一些 正面 的 有意 義的 內容
We could be having on authors, activists, politicians.	我們 可以 請 一些 作家 社會 活動家 政客
That's what people want. "Give us some shit.	那才 是 人們 想 看 的 " 餵 我們 吃屎 "
Mangia. We're the people. Give us the shit.	" 吃屎 " 是 大家 想要 的 " 餵 我們 吃屎 "
Mangia, mangia, mangia."	吃 啊 吃 啊 吃 啊
Dude, I wanted to cover actual news, not Nicki Minaj's vagina	老兄 我想 報道 真正 的 新聞 而 不是 妮琪 • 米娜 的 陰道
fuckin' flopping out at the Grammys.	在 格萊美上 走光 了
You don't like that brown sugar?	你 不 喜歡 那首 叫 " 紅糖 " 的 歌 嗎
Nothing to do with brown sugar.	這跟歌 沒關 係
I just can't keep doing this, okay?	我 只是 不能 再 這麼 做 下去 了 懂 嗎
We have to change.	我們 必須 改變
- Fine. -Are you serious right now?	- 好 吧 - 你 是 認 真的 吧
- Yeah. -Do you promise you'll do this?	- 當然 - 你 答應 要 按照 我 的 做 了 嗎
I promise if you promise you'll never leave.	我答 應 你 除非 你 向 我 承諾 你 永遠 不會 離開 我
If you promise, then I'll promise.	你 先答 應 了 我 再 答應
- Well, then, same time. -One, two, three.	- 那好 一起 來 - 123
- Promise. -Promise.	- 我答 應 你 - 我答 應 你
- Okay. -Okay.	- 就是 這樣 - 就是 這樣
That's all we had to say.	那才 是 我們 應該 說 的
- Fine. -Don't put me through that.	- 好 吧 - 別 讓 我 難過
- Okay. -I hate it when we fight.	- 好 的 - 我 討厭 我們 吵架
No, this is not a joke, okay?	不 這絕 不是 開 玩笑 懂麼
Well, I think you're being kind of condescending.	我覺 得 你 有點 太 傲慢 了
- Look! Look, look, look... -What? Yeah... one second.	- 看看 看看 - 什麼 好 稍 等
Shut up. I'm on the phone.	閉嘴 我 在 打電話
- Okay? Uh...	- 那好
Dude, what the fuck, man? That was John Kerry's office.	喂 搞 屁 啊 那 是 約翰 • 克裡 辦 公室 打過 來 的
Forget that oak-tree-looking fuck.	別 再 管 那個 長 得 跟 橡樹 一樣 的 混蛋 了
This tops it. "The Times" Printed it	這個 才 是 重點 " 時代 周刊 " 刊登 的
about... about North Korea. Read the bottom.	關於關 於 北 韓看 最 下面
After all the... the death camp shit.	從 死亡 集中 營那 玩意 的 後 面開始
"Although Kim Jong-un rallies his people	" 盡管 金正恩 召集 他 的 民眾
With cries for the destruction	叫囂 著要 對 美國
"Of the United States of America, he is known	實施 襲擊 但是 他 卻 是
To be an avid consumer of American entertainment.	美國 娛樂產品 的 忠實 消費者
His favorite shows are 'The Big Bang Theory...'"	他 最 喜歡 的 電視 節目 是 生活 大 爆炸 "
And...?	還有
"...and 'Skylark Tonight.'"	" 還有 今晚 史開勒 "
Oh! Boom!	噢 那 對 了 !
This is great!	這 太棒了
This is what you were talking about.	這 就是 你 之前 說 的
I interview this guy.	我 採訪 這個 傢 伙
Are you joking me, man? He's the most	你別 他媽 的 開 玩笑 了 他 可是
reclusive leader on the planet.	這個 星球 上 最 不 喜歡 打交道 的 領袖 了
It's not gonna happen.	這 根本 就 不 可能
He lives in North Korea. We can't go there.	他 住 在 北韓 我們 去 不了 那
Dave Skylark... gets in anywhere.	戴夫史 開勒想 去 哪 就 去 哪
You remember that club?	你 還記 得 那個 俱樂部麼
Three-month waiting list.	要 排隊 三個 月
First night.	而 我 第一天 晚上 就 進去 了
I don't think it's quite the same thing.	我 想 這 完全 不可 相提 並論
Well, there were a lot of Asian girls there.	對 了 還有 很多 亞洲 女孩 在 那
It's impossible, Dave.	你 想 都 別想 戴夫
Here's what we're gonna do.	這 就是 我們 要 做 的
We're gonna do that interview,	我們 要 去 做 那個 採訪
everyone is gonna take you super-duper seriously,	每個 人 都 會 非常 非常 地 把 你當 回事
and then you're never gonna leave me.	而且 之 後 你 永遠 都 不能 離開 我
North Korea's in the Olympics, right?	北韓 參加 了 奧林匹克 對麼
I bet they have an office that is	我想 他們 一定 有 一個 辦 公室
set up to communicate with the Olympic Committee,	用來 與 奧委會 協商
so there's probably	所以 在 北韓 可能
some infrastructure for communicating with	存在 一些 機關 是 負責
the outside world through that.	與 外面 的 世界 交流 的
Good idea. Those wheels are turning.	好 主意 我躍躍欲試 了 喲
- If I leave a message for that office... -Yeah.	- 如果 我給 那個 辦 公室 留一個 訊息 - 對
- then maybe, if they're a fan of the show, -Mm-hmm.	- 然後也許 如果 正巧 他們 也 是 我們 節 目的 粉絲 - 嗯 哼
- Mm-hmm. Mm-hmm. -that can actually work.	- 嗯 嗯 - 那 就 真 行得通 了
- We could interview the most famous man on the planet. -Yeah.	- 我們 就 可以 採訪 這個 星球 上 最 著名 的 人 了 - 對
- That would be the biggest interview ever. -Yeah...	- 那將 成為 史 無 前例 的 採訪 了 - 對
Guys, guys, guys, guys! I don't know if you've	大伙 們 我 不 知道 你們 聽 說 了 沒
heard this, but some pictures just came out	但是 剛剛 有 照片 流出 來 了
where it looks like McConaughey's fucking a goat.	馬 修 • 麥康納 正在 上 一 隻 山羊
- Whoa. "McConaughey Goat Fuck"? -Ew...	- 哇 " 麥康納 幹 山羊 " - 呃
McConaughey Goat Fuck.	麥康納 幹 山羊
Uh...	嗯
Okay, we obviously have to have him on to do that,	好 吧 顯然 我們 應該 讓 他 上 節目 了
so... we should put that together.	所以 我們 雙管 齊下
But we're doing this North Korea thing, okay?	我們 還是 要 採訪 金正恩 的 對 吧
- First thing tomorrow. Okay. -Book him, though. Book him.	- 明天 第一件 事 就是 籌備 金正恩 的 採訪 - 約 他 快 去 約 他
- Get him, get him, get him! Get the goat! -I'm on him.	- 約 到 他 一定 要 約 到 他 還有 那 隻 山羊 - 包在 我 身上 了
Get the goat!	把 山羊 帶過 來 !
I got some questions for that goat.	我 有 一些 問題 想問 那 只 山羊
Hello. This is Aaron Rapoport from "Skylark Tonight."	你好 我 是 來 自 " 今晚 史開勒 " 的 艾倫 • 雷特波
We heard your Supreme Leader is a big fan	我 聽 說 你 們 的 最高 領袖 是 我們 節 目的 死忠 粉絲
of our show, and we'd love to have him on.	所以 我們 想 邀 請 他 上 節目
Uh, please get back to me and let me know.	嗯 如果 可以 請 回 復 我
I'm about to head to an important meeting,	我要 去 參加 一個 重要 的 會議
but, uh, I'll be around in the morning.	但是 嗯 我 在 早晨 會有 時間
Hope to hear from you.	希望 能 收到 你們 的 回 復
Ooh! Yeah.	哦 爽
- Hi. -Hey.	- 嗨 - 哈羅
Uh, Mercer and Spring, please.	嗯 去 美世 酒店
Whoo!	喔
Hello?	你好
Hello. Who dis?	你好 請問 你 是 哪位
I am trying to reach Aaron Rapoport.	我 找 艾倫雷 特波
You got Aaron Rapoport.	我 就是 艾倫雷 特波
- Who dis is? -You left word	- 你 是 誰 啊 - 關於 採訪 的 事 您給
with our office regarding an interview.	我們 辦 公室 留 了 言
Look, Dave, is this you?	嘿戴夫 是 你 嗎
'Cause if it is,	如果 真是 你
you're doing a terrible Asian accent.	你 的 亞洲 口音 還 真是 爛耶
Me so "Solly."	索裡 啦
Me gots to go now, son.	我 得 閃 啦 乖兒子
I am from the office of Sook-yin Park,	這裡 是 朝鮮 民主 主義 人民 共和 國
Secretary of Communications	外務省
with the Democratic People's Republic of North Korea.	樸素 英辦 公室
Oh, my God. Uh...	哦 天 啊 呃
Shit. Uh, me so solly.	幹 呃 我 搜 搜里
I mean, I'm so solly. I mean, I-I'm so sor...	我 是 說 我 非常 搜里 不 對 非常
I'm-I'm... I'm so sorry. I'm sorry.	我 我 非常 抱歉 十分 抱歉
We would like to discuss the possibility of a meeting	我們 想 與 您 商討關 於 最高 領導 人 和
between the Supreme Leader and Dave Skylark.	戴夫史 開勒 的 採訪
Security concerns dictate	出 於 安全 考慮
that the matter be discussed in person.	我們 必須 面談
Uh, okay, great. Where... where do you do that?	噢 好 的 哪裡 見面
We will meet at latitude 40.1326,	緯度 40.1326
longitude 123.9889.	經度 123.9889
Just 'cause I'm not, like, totally familiar	我 對 於 經度 和 緯度
with my longitudes and latitudes,	完全 沒有 概念 ..
where is that again?	再 說 一遍 在 哪
50 kilometers west of Dandong, northeastern China.	中國 東北省 丹東 市西 50 公里
Did you just say "China"?	你 剛剛 說 " 中國 "
And did you just say "Dong"?	又 說 了 什麼 " 東 "
Going to motherfucking China, y'all.	居然 要 去 他媽 的 中國 搞 屁
Excuse me, can I get in there?	抱歉 我能 坐裡面 嗎
Thank you.	多謝
Hi, there.	嗨 你好
No, thank you.	不了 謝謝
I'll just get it through secondhand smoke.	我吸 二手 煙就夠 了
Selfie!	茄子
Well, where the fuck are they?	三小 他們 在 哪
What the fuck?	搞 什麼 鬼
No, no!	不是 吧
No! No!	別開 槍別 開槍
I'm an American journalist!	我 是 美國 記者
Aaron Rapoport!	艾倫雷 特波
I was invited here!	我 是 被 請 來 的
I come in peace!	和平 使者
I'm here for interview!	我 是 來 採訪 的
Please don't kill me!	別殺 我
Mr. Rapoport, I am Sook-yin Park.	雷特波 先生 我 是 樸 素英
The Supreme Leader will grant a one-hour interview	最高 領導 人恩賜史 開勒 先生
to Mr. Skylark from inside North Korea.	在 北 韓境 內 一個 小時 的 採訪 時間
All questions will be supplied by the Supreme Leader himself.	所有 問題 由 最高 領導人 自己 提出
Terms are nonnegotiable. You have 24 hours to decide.	不能 談條件給 你 24 個小時 考慮
- That's it? -Yes.	- 就 這樣 - 是
Why didn't you guys tell me this over the phone?	電話裡 怎麼 不 說
Or Skype? Do you guys have Skype?	Skype 也 行 啊 你 們 有 Skype 嗎
Do you have Skype here? Okay.	你們 到底 有 沒 有 Skype 啊 好 吧
Well, look, can you give me some water?	能 不能 給我點 兒水 喝 ?
That guy has water!	那 人 身上 有水 啊 !
Please give me a ride somewhere!	拜 託 讓 我 搭個 便車 啊
I didn't pack well for this trip!	我 行李 帶 的 不夠
I packed like a fool!	我現 在 就 像 個 智障 一樣
Like a goddamn fool!	像 個 他媽 的 智障
Please! Please!	拜 託 拜 託
Whoa.	哇
Damn, she was sexy.	幹 她 超 性感 的
The fucking helicopter landed.	我 在 一個 鳥 不 拉屎 的 地方
I'm in the middle of nowhere.	一架 直升 機從 天而降
Two soldiers jump out.	兩個 士兵 跳 了 出來
I think I'm gonna get killed.	我 以 為 我 要 被 殺 了
Then, out comes Sook.	但 這時 素英 出現 了
I told you about her.	我 之前 跟 你 提過 她
She comes out of the helicopter.	她 從 直升 機裡 出來 的
- She's hot, super sexy. -How hot?	- 辣妹 超 性感 – 多 性感 ?
- Did you get in there? -Yeah, I fucked her in the helicopter.	- 你 進去 了 麼 - 當然 了 我 在 直 昇 機裡 幹 翻 她
My fucking man!	幹得 太好了 老兄
No, I didn't do that, dude. No!	沒 我 沒 做 老兄 沒有
- Okay. -She said we couldn't ask any of our own questions.	- 好 吧 - 她 說 我們 不能自己 提問題
They were gonna write all the questions.	所有 問題 由 他們 自己 想
We can't do it.	這事 我們 不能 做 啊
We're essentially letting him	等 於 是 借 你 的 嘴 讓 他 自己
interview himself with your mouth.	採訪 他 自己
Look!	看
Look at this buttfuck!	看看 這個 王八蛋
He's got a whole parade of nukes.	他 在 搞 核武 遊行
He's ready to use them.	他 還準備 發射 核導彈
When you score a bin Laden	採訪賓 拉登
or a Hitler or an Un,	希特勒 或者 金正恩
you take it by the balls!	可是 屌 翻天 的 事
It's the first rule of journalism.	這是 新聞界 的 第一 定律
You give the people what they want.	觀眾 要 什麼 你 就 給什麼
That's not the first rule of journalism.	這 不是 新聞界 的 第一 定律
I think that's the first rule of,	像是 什麼 馬 戲團
like, circuses and demolition derbies.	撞車 大賽 的 第一 定律
This is the biggest interview since Frosty Nixon.	這 可是 自 福克斯 採訪 尼克森 總統 ( 改編成 《 請問 總統 先生 》 ) 以來 最偉大 的 採訪 啊
- 《請問總統先生》? -I mean, in ten years,	- 淡定 哥 尼克松 - 我 是 說 十年 內
Ron Howard's gonna make a movie out of this.	朗 • 霍華 ( 《 請問 總統 先生 》 導演 ) 會 以此 為 背景 拍部 電影 呢
We do this, we can interview	我們 完成 這個 採訪
any president on the planet.	我們 就 可以 採訪 全世界 任何 一個 總統
And then you can ask them the real questions.	然後就 可以 提 你 真正 想問 的 問題
This is like eating our vegetables.	打個 比方 這就 像 吃 蔬菜
Once you eat those,	吃 完 了 蔬菜
then you get to eat the steak.	你 就 能 吃 牛排 啦
And we know Aaron wants his steak.	我們 知道 艾倫 一定 想 吃 牛排
This is like...	這就 像
"The Lord of the Rings."	《 魔戒 》
Okay?	怎麼樣 ?
I'm actually like Frodo Baggins.	我 就是 佛羅多 巴金 斯
And you are my Sam.	而 你 就是 我 的 山姆
My Samwise.	我 的 山姆 衛斯
I can't do it without you.	我 不能 沒有 你 啊
- Okay. -Come with me.	- 好 – 跟我走
To Mordor.	一起 去 魔 多
Okay, let's fucking do it.	好 他 媽來 吧
- Yeah? -Yeah.	- 真的 - 真的
As always, I'd like to thank my guest,	一如既往 要 感謝 我 的 嘉賓
Joe Gordon-Levitt.	喬 瑟夫 高登 李維
And before we go,	節目 結束 之前
I have a very special announcement.	我 有 一個 爆炸性 新聞要 宣布
With the help of my outstanding producer,	在 我們 屌 炸天 的 製 片 人 艾 倫 雷 特 波 的 支持 之下
Aaron Rapoport, I've secured the most important interview	我 搞定 了 21 世紀
of the 21st century.	最偉大 的 採訪 節目
Three weeks from tonight,	三周 後
I will be traveling to Pyongyang, North Korea,	我將 飛往 北韓 平壤
to conduct the first globally broadcast interview	為 大家 獻上 金正恩 的
with President Kim Jong-un.	首次 全球 直播 訪問
I am deeply humbled and profoundly honored	能夠 承擔 如此 偉大 的 責任
to accept this most awesome responsibility.	我 感到 無比 驕傲 與 自豪
Apparently, Dave Skylark will be interviewing	顯然 戴夫史 開勒將 要
the dictator of North Korea.	採訪 北韓 的 大 獨裁者
100 bucks Skylark thinks	我出 100 美金 賭史 開勒 認為
he's the guy from "Gangnam Style."	自己 是 在 唱 " 江南Style "
Obscene glorification of a brutal dictator.	這是 在 赤裸裸 地贊頌 一個 殘忍 的 獨裁者
This is a man who tortures,	他 折磨 他 的 子民
terrorizes and starves his own people.	讓 他們 陷入 恐慌 飽 嘗 饑 餓 的 痛苦
- Skylark is beneath despicable. -Fuck this.	- 史開勒 簡直 太無恥 了 – 胡扯
Meeee-ow.	喵
What a fucking bitch, am I right?	真是 賤人 對 嗎 ?
No, you're not right.	不 不是
He's not being a bitch. He's completely right.	他 不是 賤人 他 說 的 太 對 了
He's motherfucking peanut butter and jealous.	他 是 羨慕 嫉妒 恨
- He's not jealous. -He's putting	- 他 不是 嫉妒 - 他給 他 的 蛋蛋 上
KY jealous all over his dick.	塗滿 了 嫉妒 的 潤滑液
What is there to be jealous of?	他 有 什麼 可 嫉妒 的
Fuckers hate us 'cause they ain't us.	他們 恨 我們 就 因為 他們 不是 我們 啊
They hates us 'cause we "Anus"?	他們 恨 我們 因為 我們 " 肛門 " ? （ " 不是 我們 " 與 " 肛門 " 同音 ）
What the fuck does an anus have to do with this?	這他媽 的 跟 肛門 有 什麼關 係 ?
They hate us 'cause they ain't us.	他們 恨 我們 因為 他們 「 不是 我們 」
That's not what it is.	不是 這個 原因
- Yes, it is. -No, it's not.	- 是 的 - 不 不是
They hate us 'cause we is us,	他們 恨 我們 因為 我們 就是 我們
and what we is doing is fucking terrible.	而且 我們 幹 的 事 太 他媽 糟糕 了
They fucking hate us 'cause they ain't us.	他們 恨 我們 就是 他媽 的 因為 他們 不是 我們
- Stop saying that. They don't -Hate us 'cause they ain't us.	- 別說 了 他們 沒有 - 恨 我們 因為 他們 不是 我們
- hate us 'cause they ain't us! -Hate us 'cause they ain't us!	- 恨 我們 因為 他們 不是 我們 - 恨 我們 因為 他們 不是 我們
- They don't hate us 'cause they ain't us. -I'm used to it.	- 他們 不恨 我們 因為 他們 不是 我們 - 我 都 習慣 了
- Hate us 'cause they ain't us. -Stop it. Stop it.	- 恨 我們 因為 他們 不是 我們 - 停停
- Don't say it again. -Shh.	- 別 再 說 了 - 噓
Baby.	親愛的
Haters gonna hate.	看 不爽 的 人 看 什麼 都 不爽
And ain't-ers gonna ain't.	不 懂 的 人永遠 都 不會 懂
That is not an actual thing people say.	大家 可不是 這麼 說 的
This is what you do to haters.	你 就是 要 做給 不爽 的 人 看
You just smile.	來 笑 一個
What is that?	什麼 東西
The strongest ecstasy I've ever done in my life.	我 所 所 吃過 的 最強 效搖 的 頭丸
Oh...	哦
Oh, what the fuck?	哦 我 操
Okay.	來 了
Okay, I'm coming.	來 了 來 了
Oh, shit.	哦 該 死 的
Oh... oh, God.	哦 哦 神吶
Mr. Rapoport.	雷特波 先生
I'm Agent Lacey	我 是 中情局 的
with Central Intelligence,	蕾 絲 探員
and this is my partner, Agent Botwin.	這位 是 我 的 搭 檔 博特溫 探員
Aaron, whoever that is,	艾倫別 管 是 誰
tell them to fuck off.	讓 他 滾
Dave, it's, uh,	戴夫 是 呃
- it's not... -Yo, I don't know who I fucked last night,	- 不是  - 我 不 知道 昨晚 上 了 哪個 妞
but I got some stink dick.	我 的 屌 超臭 的
Yo, my dick stinks!	我 的 屌 超臭 啊 !
So weird how you, like,	太詭異 了
just want to keep smelling it, though.	但 還是 忍不住 要聞
Yo, you got to come over and smell this shit.	趕緊 過來 一起 聞聞
Yo, come smell this.	快來 聞聞
You got to identify this.	看看 是 什麼
I don't know what it is.	我 不 知道 是 什麼
Excuse him.	不好意思
He has stink dick.	他 的 屌 很 臭
It kind of smells like guacamole.	聞著 像 鱷梨醬
May we come in?	我們 可以 進去 嗎
Would you, um,	你 想 呃
like a drink or some of Aaron's cocaine?	喝點 什麼 或者 是 嗑 點艾倫 的 古柯 鹼
This is not our cocaine. This is...	這 古柯 鹼 不是 我們 的 是
No, I'm sure it's not.	嗯 我 知道 一定 不是
So, uh, how can we, uh, what can we do you for?	好 吧 那麼 我們 能 做點 什麼
- Yeah, to what do we owe the pleasure? -AARON: Yeah.	- 是 啊 什麼 風 把 你 們 吹 來 了 - 是 啊
Well, Aaron, Dave,	艾倫 戴夫
as I'm sure	據 我 所知
you know already,	你們 一定 知道
Kim Jong-un is now capable	金正恩 現在 能 用
of nuking all of the West Coast.	核武器 覆蓋 整個 美國 西海岸
The point is we're talking about nuclear nations	關鍵 是 我們 在 談論 處 於 戰爭 狀態 的
at war with each other.	核武器 國家
Nuclear.	核武器
He does have one	他確 實有 一個
tactical advantage over the West.	對付 西方 的 戰術 優勢
He's more than willing to let millions and millions	他 很樂意 讓 數百萬
of his own people die.	自己 人去 送死
Ba-bam. Explosions. All over my face.	蹦 的 一聲 炸 了 我 滿臉
I'm sorry, we had kind of a long night last night.	抱歉 昨晚 我們 度過 了 有點 漫長 的 夜晚
Why are you telling us	你 為 什麼 要 告訴 我們
- all this information? -Well,	- 這些 資訊 呢 - 嗯
well, we're telling you this because you two lucky gentlemen	嗯 我們 告訴 你 們 這些 是 因為 你 們 兩位 幸運 的 紳士
are going to be in a room alone with him,	要 和 他 單獨 在 一個 房間裡
and congratulations, by the way.	哦 對 了 順便 祝賀 你 們
That's right!	這就 對 了
Which is part of the reason why we're here.	這是 我們 來 這裡 的 一部分 原因
The CIA would love it	中情局 會 很 高興
if you two could...	如果 你們 兩位 能夠
take him out.	把 他 帶 出來 ( 音同 「 幹掉 他 」 )
Hmm?	什麼
- Take him out. -Take him out?	- 帶 他 出來 - 帶 他 出來
- Like, for drinks? -No, no, no.	- 比如 喝杯 小酒 嗎 - 不 不 不
- Take him out. -Take out.	- 帶 他 出來 - 帶出 來
- Like, to dinner? -Take him out to a meal?	- 吃個 飯 嗎 - 帶 他 出來 吃 飯 嗎
Take him out.	帶 他 出來
- Like, on the town? -Party?	- 來 城裡 尋個歡 嗎 - 聚會
No, uh...	不額
take him out.	帶 他 出來
You want us to assassinate the leader of North Korea?	你 要 我們 去 暗殺 北韓 的 領導人
- Yes. -What...?!	- 是 的 - 什麼
If we kill him, won't they just get	如果 我們 殺 了 他 他們 就 不會
another chubby dude with a goofy hairdo	找 另 一個 有 著 智障 髮 型 的 肥仔
to come in and replace him?	來 代替 他 嗎
- Exactly, exactly. -And then the same thing happens?	- 沒錯 沒錯 - 然 後 又 重蹈 覆轍
Uh, actually, we're aware of a small faction	嗯 實際上 我們 得知 他們 現任 領導階層 的 小 的 派系
in the existing leadership that already wants him gone.	一直 很 希望 他 能 消失
They want change; they're too scared to act alone,	他們 想要 改變 但 他們 不敢 單獨 行動
and they need you two to go in there...	並且 他們 需要 你們 兩個 去 那裡
Hmm...	嗯
remove Kim, embolden them to revolt	幹掉 金正恩 鼓勵 他們 起義 反抗
and take over.	和 接管 政權
Are you, Agent Lacey, going to be involved?	蕾 絲 特工 你 會 參 與 嗎
I am going to be in your ear,	我會作 為 你 的 耳目
by your side, every step of the way.	在 漫漫 長 路上 陪伴 著 你
Then I have one answer.	那麼 我 的 答案 是
No more Kim.	金正恩 消失
Uh, you know what?	額 你 知道 嗎
Actually, I think we should talk about it more.	事實 上 我 認為 我們 應該 好好 談一談
- Okay, all right. -Okay, let's just...	- 好 的 好 吧 - 好 的 那 我們 就
- We're just gonna talk. -We're just gonna talk.	- 我們 只是 談談 - 我們 只是 談談
By all means.	當然 可以
Just for the record,	鄭重聲 明下
I don't have stink dick.	我 的 屌 不 臭
Come over here, come here, come in here...	過來 過來 到 這兒 來
I think we need to do this.	我 認為 我們 應該 做 這件 事
She is so cool.	她 真是 太酷 炫 了
You don't see what's happening, and it's so obvious.	你 不 懂 到底 發生 了 什麼 但 這很明顯
- It's crazy, man. -What?	- 太瘋狂 了 伙計 - 什麼
They're honeypotting us.	他們 在 用 美人 計色惑 我們
- What? -It's an attractive	- 什麼 - 一個性 感到 爆 的
spy woman who lures men	女特工 引誘 男人 們 去
into doing shit they're not supposed to do.	做 不該 他們 去 做 的 狗屁 任務
How can you not see that?	你 怎麼 就 不 懂 呢
- Because that is so sexist. -Is it?	- 因為 這是 性別 歧視 - 是 嗎
This is 2014.Dude...	現在 都 2014 年 了 老兄 都 什麼 年代 了
Women are smart now.	女人 現在 都 很 聰明 了
Do you actually think she just so happens	你 真的 認為 她 碰巧 擁有
to have everything you find attractive?	吸引 你 的 一切 因素 嗎
Bangs, giant tits, glasses?	瀏海 巨乳 眼鏡 嗎
They're fake, man.	他們 都 是 騙子 老兄
Fake glasses?	假 的 眼鏡
How could the CIA come up with such a thing?	中情局 怎麼 會 想 出 這樣 的 事情
Well, that poor girl is blind as a bat.	那可憐 女孩 比 蝙蝠 還 看不清楚
Okay, I'm just saying that when we're on Molly	好 吧 我 說當 我們 在 吸毒 時
and when we're horned up might not be...	和當 我們 勃起 的 時候 可能 不太能 ...
- Horned up? -You are horned up.	- 勃起 - 你 勃起 了
Oh, please!	哦 我 靠
You got half a fucking chub right now!	你 的 懶 趴 都 硬 了 一半 了
- Take your hands away. -Hmm-mm.	- 手拿開 - 不要
- I saw the boner. -I'm not taking my hands away.	- 我 都 看 見 你 勃起 了 - 我 就 不 把 我 手拿開 你 咬 我 啊
Move your fucking hands.	把 你 那 該 死 的 雙手 拿 開
Fine, you want to see it?	好 吧 你 想 看
- Yeah. -Feast your eyes.	- 嗯 – 看個夠 吧
Okay, here's what's gonna happen.	好 的 這 就是 我們 要 做 的
I'm gonna poop out these drugs.	我 去 把 這些 毒品 吸完
You're gonna go jerk off these thoughts.	你 去 清清 槍 把 那些 想法 清掉
If we both still want to talk	如果 之 後 我們 還要
about this afterwards, then we can, but not until then.	討論 這個 就 討論 但 不是 現在
Dave Skylark never backs down from a jerk-off.	戴夫史 開勒絕 對 該 打手 槍 就 打 不會 退縮
In three days,	三天 後
you will fly from New York to Beijing,	你們 將會 從 紐約 飛往 北京
where you will transfer to a commercial airline	從 北京 轉商業 航班
that takes you directly to Pyongyang.	直飛 平壤
I'm sorry, this is completely unrelated,	抱歉 打個 岔 啊
but, um, what happened to your glasses?	額 你 的 眼鏡 怎麼 了
Oh, I... I got LASIK.	哦 我 我 做 了 雷射 矯正
Between the time I saw you and now?	從 我們 上次 見面 到現 在 的 這段 時間 之間 去 做 的 ?
- Yes. -Okay.	- 是 的 - 好 的
Now, our intelligence suggests that you will be taken here,	現在 我們 的 情報 顯示 你 們 將被 帶 到 這裡
to Kim Jong-un's personal compound.	從 這裡 進入 金正恩 的 秘密 軍事 管轄區
So, preceding the interview,	所以 採訪 前
you are going to shake Kim's hand,	你 要 和 金正恩 握手
administering a fatal dose of poison	用 這個給 他 一個 致命 劑量 的 毒藥
with this, a transdermal time-delayed	一種 透過 皮膚後延時 發作 的
ricin strip.	蓖麻 毒素
When you shake his hand,	當你 和 他 握手 時
the poison will be absorbed into his skin,	毒藥 將會 滲入 他 的 皮膚
where it metabolizes for a 12-hour period.	在 12 小時 內代謝
Nobody will have any idea you two were involved.	沒 有人 會 知道 是 你 倆 弄 的
No one will know?	沒人會 知道
The United States must maintain total and complete deniability.	美國 一定 會 徹底 地 否認
- Total deniability? -Obviously.	- 完全 否認 - 當然
- This isn't what I pictured. -What did you picture?	- 這和 我 想像 的 不 一樣 - 你 怎麼 想像 的
I walk in there like a fucking gangster	我會 像 一個 他媽 的 的 幫派 分子 一樣 走 進去
and blow his little fucking ass away	當著 電視 直播 的 面
on television.	轟掉 他 的 小 屁股
This is a major television event.	這是 一個 爆炸性 的 電視 新聞
You don't want to blow it with off-screen death.	你 不會 想 在 電視 直播 畫面 外幹 掉 他
Okay?	好 嗎
Look, in porno, we call this the money shot.	在 A 片裡 有個 東西 叫做 moneyshot ( 射精 鏡頭 ， 有 拍 到 射精 畫面 才 有 錢領 所以 叫 moneyshot )
You don't have a bunch of dudes going at it,	現在 的 情況 就 像
and then right before they finish, you cut to black	你 在 一群 男優 在 射 了 之前 就 切換 到 黑幕
and say, "Oh, don't worry,	然後說 哦 不用 擔心
12 hours later, they came all over each other."	12 小時 後 他們 會 把 對 方射得 滿身 都 是
No! We want	不 我們 想要
the all-over close-up.	全身 都 是 洨 的 特寫 鏡頭
All over his face.	整個 臉 都 是 洨
The end!	結束
Ah...	啊 ~ 啊 ~
Bam!	蹦
What kind of porn are you watching?	你 是 看 了 哪種 A 片 啊
What happens when all of his guards	你 在 所有 警衛 面前
start firing back at you for killing their leader	殺死 他們 的 領袖
right in front of them?	他們 一起 向 你 們 開槍 你 們 怎麼 辦
- That's a good question. -My bulletproof vest...	- 問得 好 - 我會 穿 防彈 背心
No, you don't have a bulletproof vest.	不 你 沒 有 防彈 背心
- You don't have one of those. -I will dodge those bullets.	- 你 沒 有 其中 的 任何 一件 東西 - 我將 避開 那些 子彈
What happens after you escape the compound, Dave?	當你 逃出 軍事 管轄區 會 發生 什麼 戴夫
I look back over my shoulder.	我 回頭 一看
I see Aaron. I grab him by the hand.	我 看見 艾倫 我 抓住 他 的 手
We run out into the woods.	我們 跑 進 那片 森林
Perhaps there's a secret tunnel there.	也許 那裡 有 一個 秘密 隧道
We exit said tunnel.	我們 從 隧道 出來
At a designated spot, SEAL Team Six	到 一個 指定 的 地點 海豹 突擊六隊
swoops in, puts us on one	衝出 來 帶 我們 上 一個 汽艇
of those inflatable motorboats, we hit the water,	我們 破水 而 去
we're out of there, on our way to you.	我們 離開 那裡 回到 你 這邊
If you did try to do this, what would kill you first?	如果 你 打算 這樣 做 什麼 會 先 殺 了 你
Sub-freezing temperatures.	低 於 冰點 以下 的 溫度
I don't like the cold.	我 不 喜歡 那麼 冷
- Okay, we... -Starvation, starve to death.	- 好 吧 我們 - 餓 死 活活 餓 死
You telling me the CIA doesn't have	你 是 說 美國 中央 情報局 沒有
North Face jackets and some Pirate Booty?	NorthFace 牌 外套 和 一些 PirateBooty ( 餅乾 品牌 ) 嗎 ?
Cap'n Crunch?	嘎吱 船長 ( 玉米片 品牌 )
What about Siberian tigers?	還有 野生 的 東北虎
- Did you think about that? -What?	- 你 想 好 怎麼 對付 這個 問題 了 嗎 - 什麼
You're not going to shoot him.	你 不能 射殺 他
There's not going to be a bulletproof vest,	沒有 防彈 背心
and nobody is going to know	沒人會 知道 你 與 此
that you had anything to do with this.	有 任何 關 係
That's it, that's the plan.	就 這些 了 這 就是 計劃
- Period. -Okay.	- 對話 結束 - 好 的
Two years later,	兩年 後
I come out with my bestselling tell-all.	我 寫 一本 暢銷 書 出來 全盤 托出 所有 事情
"An Unexpected Journey:	《 意外 旅程 ( 學 哈比人 )
Dave Skylark's Adventures in North Korea."	戴夫史 開勒 的 北韓 歷險記 》
You can't write a tell-all.	你 不能 寫 一本 全盤 托出 的 書
"We were an oddly-shaped gray room	我們 在 中情局 總部
"At the CIA headquarters.	一個 奇 形怪 狀 的 灰色 房間裡
The titillating Agent Lacey..."	這 令人 興奮 的 蕾 絲 特工
Stop doing that.	別 那樣 做
- Why? -There's no tell-all.	- 為 什麼 - 沒有 什麼 全盤 托出
"'There's no tell-all, ' Agent Lacey said.	沒有 什麼 全盤 托 出蕾絲 特工 說
"She looked at him.	她 看 著 他
She trembled with rage, or was it passion?"	她 是 憤怒 得 發抖 還是 熱情
- Stop it. -I just want everybody to know	- 別鬧 了 - 我 只是 想 讓 所有人 知道
that I know what you did to me	我 知道 你 用 眼鏡
- With the glasses? -What?	- 對 我 做 了 什麼 - 什麼
- Honeycombed me. -What does that even mean?	- 色誘 我 - 你 到底 說 什麼 啊
You honeypotted him. It's honeypot.	妳 色 誘 了 他 美人計
- You honeypotted me. -You honeypotted him.	- 妳 色 誘 我 了 – 妳 色 誘 了 他
- No, I didn't. -He's said a lot of stupid shit	- 不 我 沒 有 - 他 最 後 十分 鐘
in the last ten minutes, but for reals,	說 了 一堆 屁話 但 事 實上
you did honeypot him.	妳 確實色 誘 他 了
I bet you got him in here as a honey dick	我敢 打 賭 你 怕 我 是 個 同性 戀
just in case I'm gay, but I'm not,	為 了 保險 起見 帶 他 在 這色 誘 我 但 我 不是
but if I was, I would've seen him coming a mile away.	但 如果 我 是 我 老遠 一英並 就 會 看 見 他
- You honey dicking? -Look, she's not honeypotting you,	- 色誘 你 - 你 聽 著 她 並沒 有色 誘 你
- and I'm not honey dicking him. -It's very offensive,	- 而且 我 也 沒 有色 誘他 - 這太無禮 了
'cause basically if you think about what you're saying to me,	因為 基本上 如果 你 是 像 你 對 我 說 的 那樣 看 我
you're saying because I'm a girl,	你 就 等 於 說 因為 我 是 個 女生
and because I'm attractive,	而且 因為 我 有 吸引力
my only use for this agency would be to manipulate men.	所以 我 在 這裡 的 用 處 只是 為 了 操縱 男人
I think it's offensive, too.	我 也 認為 這樣 很 無禮
and that's exactly what I said to Aaron.	這 就是 我 對 艾倫所 說 的 話
I said that bitch is blind as a bat.	我 說 那個 婊子 瞎 得 像 只 蝙蝠
Can we please move on?	我們 可以 繼續 討論 嗎
We have a dictator to kill.	我們 要 殺 一個 獨裁者
When handling the ricin strip,	當處理 蓖麻 毒素 繃帶 時
operate with extreme caution.	一定 要 小心 謹慎 操作
Even momentary flesh contact with the exposed strip is fatal.	即使 短暫 的 肉體 接觸 繃 帶 也 是 致命 的
The poison will lay dormant for 12 hours.	12 小時後毒 藥會代謝 完畢
After it passes the blood-brain barrier,	通過 血腦 屏障 後
your heart rate would shoot up to 160.	你 的 心率 將飆 升到 160
Your body will strain to reject the poison	你 的 身體 會 不停 地 出汗 腹瀉 嘔吐
by profusely sweating, defecating, vomiting.	抗拒 這種 毒素
Within minutes, you will be dead.	幾分 鐘內 你 就 會掛 了
- Okay. -Got it?	- 好 了 - 聽 明白 了 嗎
Aaron peels off the film marked A,	艾倫 撕掉 標了 A 的 薄膜
exposing the adhesive coating.	讓 黏合 層 暴露出 來
He then applies the strip to Dave's palm.	然後把 它 貼 在 戴夫 的 手掌 上
- Okay... -Aaron will then remove the film marked B,	- 好 的 - 艾倫然 後 再 撕掉 標了 B 的 薄膜
exposing the ricin.	讓 蓖麻 毒素 露出 來
- Clear. -Okay, clear.	- 清楚 了 - 好 的 清楚 了
- Okay. -Okay.	- 好 的 - 好 的
Dave needs to appear casual	戴夫要 顯得 隨意點
as he is transferred from his room	在 他 從 房間 走 到
- Okay. -to the broadcast facility.	- 好 的 - 直播 間 的 時候
It is critical that he keeps his hand open	很 重要 的 一點 是 他 要 把 他 的 手 張開
and touches nothing.	然後什麼 都 別 碰
Dave Skylark.	戴夫史 開勒
- -Mr. Kim...	金 先生
Just shaking hands.	只是 握手
Hi.	嗨
Nice to meet you.	很 高興見 到 你
Dave will bow to Kim	戴夫會 向 金正恩 鞠一躬
then shake his hand,	然後與 他 握手
immediately disposing of the strip	然 後 立即 撕掉 繃條
in his jacket pocket, which will be lined	放進 夾克 口袋 裡
with an absorbing agent that denatures the poison.	夾克 的 內 襯會 吸收 改變 毒藥 的 性質
- -Oh, no!	- - 哦 不
Hey! Hey!	嘿嘿
Agent Lacey!	蕾 絲 特工
- What's this mean? -You're dead.	- 這是 什麼 意思 - 你掛 了
All right, Mr. Skylark, so you'll just place	好 吧 史 開勒 先生 所以 你 就 在
the ricin case in this pouch here.	這裡 放 這個 袋 蓖麻 毒素
It will magnetically seal,	它會 被 磁性 密封
and then you're good to go.	然 後 你 可以 安全 的 走 了
So you want me to carry this bag?	那 你 的 意思 是 讓 我 拿 著 這個 包包
This is the bag.	這 就是 那個 包
This is a douche bag.	這個 包醜 爆 了
The watches conceal an array of tactical functions.	這些 手表 隱藏 了 很多 戰術 功能
It's how you stay in contact with me and the command center.	你 用 這個 跟 我 保持 和 指揮 中心 聯絡
- Aaron to Dave. -All radio communication	- 艾倫 呼叫 戴夫 - 所有 的 無線 電通訊
should be done using call signs.	都 需要 有代號
- Cool. -Dave,	- 真酷 - 戴夫
you are "Dung beetle,"	你 是 糞 金龜
- What? -And Aaron, you are "Aardvark."	- 什麼 - 還有 你 艾倫 你 是 食蟻 獸
I can't even carry this thing!	我 可 不能 帶著 這個 東西
What do you mean you can't carry it?	為 什麼 說 你 不能 帶著 這個 包
Aerodynamics are all off.	不 符合 空氣動 力學
It's hitting my leg.	不時 碰到 我 的 腿
It's, like, bulky.	太 笨重
Please remember, gentlemen, you are entering into	一定 要 記住 二位 你們 將要 去
the most dangerous and unpredictable country on Earth.	世界 上 最 危險 而且 不可 預測 的 國家
Kim Jong-un is a master manipulator.	金正恩 是 個 操 縱別 人 的 大師
His people revere him as a god.	他 的 人民 將他 奉 為 神
They'll believe anything	他們 會 相信 任何
he tells them, including that he can speak to dolphins	金正恩 告訴 他們 的 包括 他 可以 和 海豚 說話
or he doesn't urinate and defecate.	還有 金正恩 他 從 不 大小便
Whoa, whoa, whoa, whoa...	喔 喔 喔 喔
You're telling me my man doesn't pee or poop?	你 在 跟 我 說 有人 從 不 大小便
I'm telling you he does, and he lies	我 的 意思 是 他 需要 但是
to his people and they believe him.	他 對 他 的 人民 撒 了 謊 而 他們 相信 他
Everybody pees and poops.	每個 人 都 要 上 廁所
Where would it go otherwise? He'd explode.	否則 他 會 爆屎 的
But he does talk to dolphins.	但是 他 的 確能 和 海豚 交流
All right, how do I look?	好 吧 我 看 起來 怎麼樣
Fucking awesome?	帥到 掉 渣
Yeah, actually, this is really, really nice.	恩說 實話 你 還挺 不錯 的
- Yeah. -And that just...	- 是 啊 - 但 這
What the fuck is this?	這他 媽是 什麼
- It's my bag. -It's wonderful.	- 這是 我 的 包包 啊 - 包包 不錯
That's just not the bag the CIA gave you.	但 這個 不是 中情局 給你 的 那個 啊
Oh, that bag?	哦 你 說 那個 包 啊
Yes, that bag!	對 那個 包
That bag was Fugly with a capital "Fug."	那個 包 簡直 醜到 爆 了
Well, it was also designed to conceal fucking poison	但是 那個 包裡面 有 該 死 的 毒藥
that we're gonna smuggle into a foreign country.	我們 要 帶 到 外國 去 的
Kim is a super fan.	金正恩 是 個 超級 粉絲
He knows I take fashion risks.	他 知道 我 是 個 潮 男
Look, I show up with that other bag,	你 想想 我 要是 拎 著 那個 包
Kim's gonna be like,	金正恩 一定 會 說
: "Oh, no.	去 你 的 吧
"You got ugly bag?	帶著個 醜包 就 來 見 我
"You no Skylark, you secret agent.	你 才 不是 史開勒 你 個 該 死 的 特工
Terminate him."	幹掉 他
Where's the fucking poison strip?	那該 死 的 的 毒藥 呢
I put the strip in a pack of gum.	我 把 它 放到 一疊 口香糖 裡
They'll never find it.	沒人會 發現 的
I am not cool with this.	我 不 放心
- It's showtime. -Showtime?	- 好戲 要 上演 了 - 好戲
It's not showtime.	根本 沒有 好戲
- What are you doing? Stop. - "Dave Skylark Tonight!"	- 你 幹什麼 站住 - 今晚 史開勒
Stop walking!	給我 站住
- Stop walking. -Hello.	- 停下 來 - 你好
We are going to North Korea.	我們 將會 去 北韓
Yo, Skylark, which side	嗨 史 開勒
of President Kim's ass you gonna kiss?	你會親 金正恩 的 哪邊 屁股
I'm not gonna kiss him, but let's just say	我 才 不會親 他 但是 我
I might give him something special with my hand.	可能 用 手給 他 來點 特別 的
You gonna jerk him off?	你 要給 他 打手 槍 ?
What? No. That's a double entendre.	什麼 哦 不 那 是 雙關語
Shut the fuck... Shut up!	他媽給 我閉 嘴閉 嘴
- I'm foreshadowing! -Shut up!	- 我 只是 在 埋伏 筆 - 閉嘴
Shut up! Get in the fucking car!	閉 嘴快 他媽 上車
Shut up! Shut up!	閉嘴 閉嘴
Why would you say that? Why would you say that?	你 為 什麼 要 說 出來
All right, here we go.	好 的 我們 來 了
What's that noise?	那 是 什麼 聲音
- I don't know. -Do you hear that?	- 我 不 知道 - 你 聽 到 了 嗎
Yeah.	聽到 了
Wow.	哇 靠
This is crazy.	太扯 了 吧
- Hello, North Korea! -Wow.	- 北韓 你好 啊 - 喔
This is crazy.	簡直 瘋 了
Okay, okay.	好 吧 好 吧
North side! -Okay.	北邊 的 朋友 你們 好 嗎
Hi. Sorry about... what he's doing.	你好 抱歉 不要 介意 他
Hello! Wow...	你好 喔
I like your style.	我 喜歡 你 的 風格
Good to see you again. How are you?	很 高興 再 一次 見 到 你 你好 啊
- Hi. -Hello.	- 你好 - 你好
- Hello. -This is great.	- 你好 - 這 太棒了
Uh, Dave, this is, uh, Sook-yin Park.	呃 戴夫 這位 是 樸 素英
- Sook? The Sook? -Yes, yes.	- 素素 女士 嗎 - 恩是 的
That you won't stop talking about?	你 一直 談到 的 那位 嗎
That's not true.	別 瞎扯
We are different people.	我們 是 不同 的 民族
We speak different languages.	說 不同 的 語言
Huh?	對 嗎
We have different faces,	我們 長 相 不同
but inside	但是 內心
we are same-same.	我們 是 一樣 的
Same-same, but different.	一樣 的 但是 又 不同
But still same.	但 還是 一樣 的
Oh, thank you.	謝謝 謝謝
Konichiwa.	你好 （ 日語 ）
You know, I'm very,	你 知道 我 對
very interested in the history of your young nation.	你們 這個 年 輕國度 的 歷史 非常 感興趣
I hear that	我 聽 說
absolutely everyone here is-is starving to death.	這裡 每個 人 都 在 被 餓 死
No.	喔 靠
It's quite all right.	沒關 係 的
This is a common misconception.	這是 個 常見 的 誤解
Oh, okay.	哦 好 的
See for yourself.	你 自己 看
Oh, wow! It's a grocery store.	快 看 食品 雜貨店 呢
Looks like the Whole Foods around the corner from my place.	看著 就 像 我家 旁邊 那家
Yep, guess no one's hungry here after all.	看來 也 沒人 填 不 飽 肚子
We have an abundance of food here.	我們 這裡 食物 很 充裕
And speak of the devil, look at that fat kid!	說 曹操 曹操 到 快 看 那個 小 胖子
Hi, little fatty!	你好 呀 小 胖子
Hi. Mm-mm!	你好
We have many fat children in North Korea.	我們 北 韓有 很多很多 的 小 胖子
The Supreme Leader	我們 偉大 的 金 領袖
believes it is a hallmark	覺得 這個 是
of prosperity and self-sufficiency.	國家 昌盛 自足 的 象 徵
I don't know about all that,	其他 的 我 不 知道
but this one is one that I heard.	但是 我 聽 說
I heard he doesn't pee or poo.	金正恩 他 不 大便 也 不 小便
He works so hard, he burns the energy from inside.	他 超級 努力 工作 能量 在 內部 就 被 消耗 了
You-You're telling me my man doesn't have to take a poo?	你 在 跟 我 說 有人 不 需要 大便
Does-does he have a butthole?	那 他 有 屁眼 嗎
He does not have a butthole.	他 沒 有 屁眼
He has no need for one.	他 不 需要 屁眼
Whoa!	哇
Ho-ho! Damn, son!	喔 喔 我 操
Damn...	靠 腰 ...
Right this way.	這邊 請
I get it. Fucking stop it.	我 知道 住手
These are Officers Koh and Yu.	這是 許長 官 和 於 長 官
They are the heads of	他們 是
our Supreme Leader's personal security.	我們 偉大 的 金 領袖 的 貼身 保鑣
They have been with him since he was a little boy.	領袖 從 小 就 由 他們 保護
They will search you one last time	他們 會 最 後 搜查 你們 一遍
before entering our Supreme Leader's home.	然 後 才能 進入 偉大 領袖 的 宮殿
Just a Gucci bag.	只是 一個 Gucci 包
What's this?	這是 什麼
Uh...	呃 …
gum.	口香糖
That is gum.	這是 口香糖
Oh, you fucking tried it?	喔 幹 你 真的 吃 了 啊 !
This gun has no flavor.	這個 口香糖 沒 味道 啊
- If you don't like it, just spit it out. -Just spit it out.	- 你 要 不 喜歡 就 吐 出來 - 吐出 來 就 好
We wouldn't be insulted if you just spat it out.	你 要是 吐出 來 我們 不會 介意 的
Your gum taste like shit.	你們 的 口香糖 吃 起來 跟 屎 一樣
Okay.	好 吧
You may now enter the Supreme Leader's home.	你們 可以 進去 了
This room	這間 房
- for Mr. Skylark. -AARON: Cool.	- 是 給史 開勒 先生 的 – 酷
Thanks.	謝謝
This room for Mr. Rapoport.	這間 是 給雷 特波 先生 的
Ooh, lovely.	太溫馨 了
- Thank you. Quaint. -Cute.	- 謝謝 真怪 - 棒
You know, I'm tired.	恩 我 有點 累 了
How are you feeling?	你 覺得 呢
- We go now. -AARON: Okay.	- 我們 走 了 - 好
Dude, what the fuck?	大哥 了 我 操
Hey, uh, you know,	呃 你 知道 的
- how's your tummy feeling? -You should have some Tums.	- 你 肚子 怎麼樣 - 你 應該 來 點藥
Maybe you should have some tea.	可能 你 應該 來點 茶
Fuck.	靠
-Shh. -Shh.	噓
They could be recording.	隔 墻 有 耳
- Oh, the thing. -The thing, all right, go.	- 哦 對 那 東西 - 那東西
Oh, uh... -Lovely room.	好 可愛的 房間
- Yeah. -Oh, yes.	- 是 啊 - 好
Lovely. I'm gonna go take a shower now.	好 啊 我 準備 去 洗個 澡
Okay, I'll take one with you.	好 的 我 跟 你 一起 去
Why would you take one with me?	你 為 什麼 要 跟 我 一起
I'm just making up fake conversation.	我 只是 在 編對 話 啊
Shut up. Shut the fuck up.	閉 嘴快 閉嘴
What... the... fuck... dude?	我操 我 操 我 操
He ate it. He fucking ate it.	他 把 那個 吃 了 他媽 就 這樣 吃 了
- You're not even supposed to touch it. -And he ate it.	- 你 根本 不應 該 去 動 的 - 但是 他 吃 了
- Chewing. Chewing it! -Shit! Fuck.	- 嚼 了 - 我操
Shit, he's gonna die.	靠 他 會掛 掉 的
Look, look, look, look...	好 吧 好 吧 好 吧 好 吧
He's probably, like, Kim's trigger man, okay?	他 應該 是 金正恩 的 副手 對 嗎
He's probably killed, like, tons of people.	他 可能 殺 了 很多很多 人
He's probably worse than Kim,	可能 比 金正恩 還壞
and we're okay with killing Kim, right?	所以 我們 殺 了 他 沒什麼 過不去 的 啊
Yeah.	恩
How the fuck are we gonna do that, by the way?	所以 我們 他 媽要 怎麼 殺 金正恩
We don't have any poison anymore.	我們 沒毒藥 了
What happened to it?	發生 什麼 了
- Somebody ate it. -Someone ate it?	- 有人 把 毒藥 吃 了 - 有人 把 毒藥 吃 了
Why the fuck did you switch bags?	你 他 媽為 什麼 要換 包包
- Yeah, Dave! -All right, all right!	- 對 啊 戴夫 - 好 吧 好 吧
I shouldn't have switched the bags. I'm sorry.	我 不 應該 換包 的 我 的 錯
I told you. -Listen, just sit tight.	- 我 早就 跟 你 說過 - 聽著 乖乖 呆 著
I am going to contact you.	我會 聯絡 你 們
Do not fall asleep.	別 睡 著
I'm gonna figure out a way to fix this.	我想個 辦法 補救 一下
Thanks. Why'd you tell her?	謝謝 你 為 什麼 要 跟 她 說
Tell her what? Because it's the truth.	跟 她 說 什麼 因為 這是 真相 啊
Why'd you tell her that he ate it?	你 為 什麼 要 跟 她 說 他 吃 了 毒藥
Because he did!	因為 他 吃 了 啊
Dude, that was a cock block.	大哥 那 我們 可真 沒轍 了
Get me Major Franks at the Osan Air Force Base.	給我接 烏山空 軍 基地 的 弗蘭克 上校
ETA to launch zone, 20 minutes.	預計 到 達 發射 地點 時間 20 分鐘
We have a bird en route.	我們 發射 了 一個 無人機
It will be within range of you in 15 minutes.	大概 15 分鐘 到 你 們 附近
Aardvark,	食蟻 獸
your watch will transmit the coordinates	你 的 手表 的 發射 的 坐標
to guide in the package.	會 引導 包裹
You need to get outside to a place with no tree cover	你 需要 到 外面 的 一片 沒有 樹木 的 空地 上
where you can't be detected.	你 不會 被 發現 的 地方
Okay?	好 嗎
What-what-what...? Lacey, why do I have to do it?	你 說 什麼蕾 絲為 什麼 是 我
Why you?	為 什麼 是 你
Because if Dung Beetle gets caught	因為 如果 糞金龜 被 抓 到
or killed, then we don't have a mission anymore, do we?	或者 被 處 決行動 就 沒法 進行 下去 了
You really think I could get caught or killed?	你 真的 覺得 我會 被 抓 到 或者 被 殺 掉
Hey, put on your darkest clothes and get outside now	嗨 快 穿 上 你 最 深色 的 衣服 到 外面 去
and make sure that you are	確保 你
at least 20 yards away from the building.	至少 離大樓 20 碼
Approaching launch zone.	接近 發射區
You ready?	準備 好 了
I think so.	恩恩
I'm a little nervous, but I'm feeling okay.	有點 緊張 但是 感覺 還好
- Okay, okay. -I think I can do it.	- 好 的 好 的 - 我 沒 問題 的
- What are you doing? -I'm gonna cherish	- 你 幹 嘛 呢 - 我要 珍惜
- all the memories we have. -Don't do this!	- 我們 在 一起 的 所有 回憶 - 別 這樣
- What? -Talk to me like I'm about to die, okay?	- 什麼 - 說 的 跟 我 馬 上 就要 掛了 一樣
- I'm gonna be fine! -All right. I know.	- 我 不會 有事 的 - 好 我 知道
I'm trying to psych myself up here; you're bringing me down.	我本來 都 給準備 好 了 了 你 又 來 搗 亂
I will love your mother like she was my mother.	我會 把 你 媽當 我 媽來養 的
- Just shut up. Shut up. -Okay.	- 你 就 閉嘴 吧 閉嘴 - 好 吧
Shh.	噓
It's really scary out there.	外面 好 可怕
Yeah, super-duper scary.	對 超級 可怕
- Be careful. -Okay, good. You got me?	- 小心 點 - 好 的 沒 問題 你 抓緊 我 了 嗎
- I got you. I will not drop you. -Okay.	- 我 抓住 你 了 不 會 鬆 手 的 - 好
- Yeah, just don't drop me. -I got you.	- 好千萬 別 鬆 手 - 我 抓 著 你 呢
- I got... Oh! -	- 我 抓 … 幹 !
Aardvark, are you all right?	食蟻 獸 你 還好麼
I'm fine. Shut the fuck up.	我 沒事 你 他 媽閉 嘴 吧 你
Aardvark is hot.	食蟻 獸 準備 好 了
Aardvark is H-O-T hot.	食蟻 獸 準備 好 了
- This is so scary. -LACEY: Aardvark?	- 很嚇 人 啊 - 食蟻 獸
You're being extremely brave.	你 真 勇敢
Everybody here is very proud of you.	大家 都 為 你 自豪
- My tummy's all scraped up and wet. -Aardvark,	- 我 肚子 上 都 是 濕 的 - 食蟻 獸
I'm gonna rub your tummy when you get back, don't worry.	等 你 回來 我 幫 你 揉 揉 別 擔心
Just a few more feet, okay?	就 再 過去 幾 英尺 好麼
Just five to ten more feet.	再過 去 幾 英尺
I got to keep going?	我 還要 繼續 爬 嗎
I don't want to keep going.	我 不想 爬 了
Fuck.	靠
Package will deploy in three, two, one, boom.	包裹 釋放 321
Package is inbound.	包裹 入境 了
Arrival time, two minutes.	兩分 鐘後到 達
Just five more feet.	再過 去 5 英尺
Five more feet, and you're on your mark.	5 英尺 你 就 到 標記 的 地方 了
Hey, hey,	嘿嘿
hey, don't move.	嘿別動
I think I see something.	我 好像 看到 了 什麼 東西
- Huh? -There's something out there.	啊 有 什麼 東西 在 那邊
What do you mean, there's something out there?	你 什麼 意思 那邊 有 什麼 東西 啊
What is it? Can you zoom in on that?	那 是 什麼 你 能 放大 嗎
What do I do?	我該 怎麼 做
Comm One, are you seeing this?	我 靠 你 看 見 了 嗎
Zoom in one that thing.	把 那 玩意 放大
What is that?	這是 什麼 啊
There's something crawling towards Aardvark.	有個 東西朝 著食 蟻 獸 爬 過去 了
What the fuck? What is it? Talk to me.	我操 那 是 啥 快 告訴 我
I'm seeing four legs connected to one body.	我 看到 一個 軀體 連著 四條 腿
What the fuck are you seeing? I'm not seeing anything.	你 他媽 看到 的 是 什麼 啊 我 什麼 都 沒 看 見
Dog, big dog.	狗大狗
- Big dog? -It's like Clifford size.	- 大狗 - 和 大紅狗 一樣 大
We're talking Falkor in "The Neverending Story."	我們 正在 討論 永不 停歇 的 故事 中 的 福客
It's like a dragon dog.	它 像 龍 狗
This is like a dragon dog.	像 龍 狗
Is that a fucking...	那 他媽 是 ..
Guys, what am I looking for? I don't know...	哥們 我 應該 找 啥 我 不 知道
It's like a big dog	它 像 隻 大狗
that's orange.	是 橙色 的
It's got stripes.	還有 條紋
It's like a big, orange, stripey dog.	它 是 一條 橙色 的 有 條紋 的 狗
There's a tiger.	是 老虎
It's a fucking tiger.	幹 他媽 的 是 老虎
It's a fucking tiger.	幹 他媽 的 的 是 老虎
Yes.	對
A tiger.	老虎
You fucking led my friend into a tiger patch?	幹 你 讓 我 朋友 去 一個 老虎 的 地盤
I told you there were tigers there.	我告 訴過 你 那裡 有 老虎 的
Guys, I'm very unhappy right now.	大家 我現 在 感覺 有 桑心
Look, it's really dark out there.	聽著現 在 外面 很 黑
He probably doesn't see you.	老虎 可能 看不見 你
Oh, it fucking sees me. -	幹 牠 已經 看見 我 了
- It ha... it has night vision. -They have night vision?	- 牠 .. 牠 能 夜視 - 他們 晚上 能 看見 東西
That tiger has night vision goggles?	老虎 還戴夜 視鏡 啊
It doesn't have night vision goggles.	老虎 不是 戴夜 視鏡
It just naturally has night...	而是 天生 的 有 夜視 能力
Listen, just keep the line clear,	聽著 保持 通訊 順暢
Dung Beetle, please?	糞金龜 拜 託 了
Aardvark is in trouble.	我 有 麻煩 了
What do I do? What do I do?	我該 怎麼 辦 我 該 怎麼 辦
Talk to me, talk to me.	告訴 我 告訴 我
I didn't want it to come to this,	我 不想 這樣
but you're gonna have to fight that tiger.	但是 你 要 跟 那 隻 老虎 打
No, do not! Do not fight the tiger!	不千萬別 不要 和 老虎 打
Do not be a gentleman, you go right for the fucking balls.	別裝 紳士 直接 上去 打 老虎 的 蛋蛋
I don't see its balls.	我 沒 看到 它 的 蛋蛋 啊
Do not fight the tiger! You will lose!	別 和 老虎 打 你 會輸 的
If that's a girl tiger, you got to cunt punt that bitch.	如果 是 只 母老虎 你 必須 踢 那 賤貨 的 下面
- Dave, shut the fuck up. -Cunt punt that fucking bitch!	- 戴夫 快 他 媽閉 嘴 - 踢 她 下面
Please tell me you know that that's a stupid idea.	快 告訴 我 你 知道 這個 主意 蠢爆 了
Please, please don't try to fight the tiger.	拜 託 拜 託 不要 跟 老虎 幹架
I'm gonna make a run for it.	我 準備 落 跑 了
Do not run for it!	不要 逃跑
You will die.	你 會 死 的
It's coming.	牠 來 了
You go, go, go, buddy! Go, buddy!	快 跑 大哥 跑 大哥 快 跑
Look out, look out! It's coming after you!	小心 小心 牠 追上 來 了
It's coming after you!	牠 追上 來 了
- Oh, God, I'm alive. -Aaron!	- 哦 天 啊 我 還活 著 - 艾倫
- I'm alive. -	我 還活 著
Are you in the tiger, Aardvark?	你 在 老虎 肚子 裡嗎 食蟻 獸
Are you inside the tiger?	你 在 老虎 肚子 裡嗎
Are you okay?	你 還好 嗎
Do you have the package?	你 拿到 包裹 了 嗎
This is Aardvark.	我 是 食蟻 獸
I think the package just killed the fucking tiger.	我想 那個 包裹 剛好 他媽 的 把 老虎 砸死 了
Fantastic. You have to secure the package.	太好了 你 快 把 它 藏 起來
Secure the motherfucking package.	把 這 完蛋 玩意 藏起 來
He's got the package. He has the package.	他 拿到 包裹 了 他 拿到 包裹 了
I got it; what do I do with it?	我 拿到 了 我 應該 怎麼 做
Aardvark, there are people coming.	食蟻 獸 有人 來 了
You have to act now.	你現 在 必須 行動
Secure the package, secure the package.	把 包裹 藏起 來 把 包裹 藏起 來
- What do I do with it? -They're coming right towards you.	- 我要 怎麼 辦 - 他們 朝著 你 來 啦
They're gonna see it, they're gonna see it.	他們 要 發現 了 他們 要 發現 了
You got to hide that little missile.	快 把 那個 小導彈 藏 起來
I have to hide it somewhere?	我 必須 把 它 藏 起來
Where the fuck do I hide it?	我 他 媽藏 哪 啊
What do I do with it? What do I do with it?	我該 怎麼 辦 我 該 怎麼 辦
What if you hide it in your butt?	你 覺得 藏 在 屁眼 裡行 嗎
I don't want to stick it in my ass.	我 才 不想 把 這 玩意 插進 我 屁眼 裡
You got to put it in your butt, Aardvark.	你 必須 把 它 塞進 你 屁眼 裡食 蟻 獸
Comm One, please tell me I don't have	拜 託 不要 吧
to stick this think in my ass.	不要 把 這 玩意 塞進 我 屁股 裡
Okay, you're right. Just give us	好 吧 沒錯
one second to come up with a better plan.	給我們 點時間 去 想個 好點 的 法子
Isn't there anywhere else I could secure it?	我 就 沒 有 更好 的 地方 藏 了 嗎
I think he should put it in his asshole.	我覺 得 應該 藏 在 他 屁眼 裡
We don't have a better plan. You're going to have	我們 沒有 更好 的 方案 了
to stick it in your ass.	你 快 把 那 玩意 插 到 屁眼 裡
No! No!	不 不
No!	不
I've never done that.	我 以前 從來 沒幹過
I've been there before. It looks huge.	我 以前 幹過 它 看 起來 挺 大 的
That tiger blood will lubricate it.	但是 老虎 的 血會 起到 潤滑 它 的 作用
This will mess up my asshole!	它會 把 我 的 屁眼 搞爛 的
Aardvark, there-there are people there.	食蟻 獸 有人 來 了
They are closing in on you.	他們 正在 包圍 你
They have guns.	他們 有 槍
You need to secure the payload	你 要 把 包裹 藏起 來
and you need to secure it in your ass.	而且 是 把 它 藏 在 你 的 屁股 裡面
Just stick it in your butt.	插進 屁屁 就行 啦
Okay, fine, fine.	好好 吧 好 吧
I'm there with you, bro.	我 陪 著 你 呢 兄弟
Just listen to the soothing tones of my voice.	聽著 我 撫慰 的 語音
Just breathe.	呼吸
Oh, it's cold.	哦 好 涼
Just let everything go loose.	放 鬆 一切
Oh, I don't like it!	哦 我 不 喜歡 這樣
The tip is...	頭那裡
it's the worst part.	是 最難 插 進去 的 地方
Trust me on this.	相信 我
Inhale as you do it. -	插 的 時候 吸氣
The tip of the package is secure.	包裹 的 頭已 插 進來 了
Comm One, that thing is in his butt.	快點 那 東西 已 經進 他 的 屁股 了
Owie, owie.	哎 喲 喂 哎 喲 喂
You are almost in the end zone, Aardvark.	你 就 快要 完成 了 艾德 瓦克
Just take it home.	把 它 帶 回來 就行了
The package is secure.	包裹 已藏 好
You are a hero.	你 是 個 英雄
You are a goddamn hero.	你 真 他媽 是 大 英雄
- -All right, they're coming, they're coming.	好 他們 來 了 他們 來 了
I got to go. Over and out.	我 得 走 了 先掛 了
Hi! Aah! Don't shoot me.	嗨 啊 別 殺 我
Oh, God!	哦 天 啊
Don't hurt me, please!	別傷害 我 拜 託
See? There's nothing in here.	看見 沒 這什麼 都 沒 有
There's nothing in here.	什麼 都 沒 有
What?	啥
Oh, God, no!	哦 天 啊 不
Ow!	哦
Come on!	拜 託
What the fuck?	我操
Why? Why'd you do that?	為 什麼 你 們 為 什麼 這麼 做
Why'd you do that?!	你們 為 什麼 這麼 做
Is this what you want?	這 就是 你們 想要 的
There! You like it?!	來 啊 你 開心 了
You like it?!	開心 沒
It's all yours, fuckers!	都給 你 王八蛋
Stay in the room, American.	好好 待 在 房間裡 美國人
Hey, they're gone. Did they look in your butt?	嘿 他們 走 了 他們 有 看 你 屁眼 嗎
- No, they didn't look in my butt. -It's still in there?	- 不 他們 沒 看 我 屁眼 - 它 還在 裡面 嗎
- Yes, it's in there. -Wow. Must be deep.	- 對 還在 裡面 - 哇 哦 一定 挺深
- It is. -Get it out.	- 對 - 快 拿出 來 啊
I'm gonna fucking get it out.	我 他媽 當然 要 拿出 來 啊
I'm here to help.	我 可以 幫 你 啊
Two doses, In case you fuck up again	給你們 兩片 以防 你們 又 搞砸
-Hey.	嘿
- How'd it go? -One ricin strip with your name on it.	- 怎麼樣 一條 有 你 名字 的 蓖麻 毒素 帶
Got it.	我 懂 的
All right.	好 了
See, not so bad.	看 也 不是 很糟 嘛
Yeah, not so bad.	是 啊 不是 很糟
- What?! -Yeah.	- 啥 玩意 - 對
- That? -This.	- 這個 這麼 大 - 這麼 大
- In your bu...? -Asshole.	- 在 你 屁 - 屁眼
- No! -Yes.	- 不 - 是
I was picturing something, like, this big.	- 我 以 為 它 也 就 這麼 大
Yeah, that I could live with.	對 我 都 可以 忍受
As soon as you get home,	你 一到 家
you need to see a proctologist.	就 去 看 肛腸科 醫生 吧
I'm afraid to fucking look.	我 他媽 也 是 這麼 想 的
You got fucked by RoboCop, dude.	你 被 機械 戰警 上 了 兄弟
Uh, who is it?	額 誰
It is, uh, Kim Jong-un.	是 金正恩
What?	誰
Kim Jong-what?	金正 啥
I am the Supreme Leader of, uh, North Korea.	我 是 北韓 的 最高 領導人
What?	什麼
What the fuck?	我操
- It's him. -It's fucking him.	- 是 他 - 真 他媽 是 他
What is he doing here? What the fuck?	- 他來 干什麼 我 操
Hide it, hide it, hide it.	藏起 來 藏 起來 藏 起來
- Put it back up. -No.	- 放 回去 - 不
I'm not putting it back up.	我絕 逼 不放 回去
No, I'm gonna hide it in my room.	不 我 準備 把 他 藏 在 我 房間
- Okay. What do I do with this? -Go say hi to him.	- 好 的 我 應該 怎麼 做 - 去 跟 他 打招呼
Do I put it on right now?	我現 在 就 把 它 黏上 嗎
No, then he'll die when we're still here.	不 那樣 他 死 的 時候 我們 還沒 走 呢
- -Put it in your pocket.	放 你 口袋 裡
- Okay, fine. -Okay, fine.	- 好 吧 聽 你 的 - 好 吧 ， 聽 你 的
- Come with me. -No, I got to hide this.	- 跟 我 一起 去 - 不 我 要 把 這個 藏 起來
- Aaron, just come with me. -No, no...	- 艾倫 跟 我 一起 吧 - 不 的 不 的
Aaron, Aaron.	艾倫艾倫
Hi.	嗨
Good morning, Dave.	早上好 戴夫
Good morning.	早上好
Hi.	嗨
Dave Skylark, ah.	戴夫史 開勒哈
It's crazy.	太 屌 了
Oh, I have a gift for you.	哦 我 有 個 禮物 要 送給 你
- Oh, really? -Yeah.	- 哦 真的 嗎 - 對
This.	這個
Oh, oh, this is me.	哦 哦 這是 我
It's you.	是 你
Oh, that's great.	哦 真棒
I always wanted one of these... a bust.	我 一直 想要 一個 一個 雕像
Dave Skylark.	戴夫史 開勒
Hey!	嘿
- Thank you. -You like that?	- 謝謝 - 你 喜歡 嗎
So you really like the show?	你 真的 很 喜歡 這個 節目
No, I might not show it, but I'm freaking out.	不 我 可能 沒有 表現 的 很 明顯 但是 有點 小 緊張
You're like a superfan.	你 真是 一個 超級 粉絲
I really am.	我 確實 是
Yeah.	耶
That's so cool.	太酷 了
Don't say something stupid, Kim.	別說 傻話 金
Okay, so I, uh,	好 的 所以 我額
thought you might enjoy, uh, breakfast	想 你 會 額會 喜歡 吃 早餐
and a tour of my home.	然後在 我家 逛逛
I'd absolutely love to.	必須 的
You know, I have to admit, before I came here,	你 知道 嗎 我 必須 要 承認 我 來 之前
I thought this place was gonna be a dump.	我 認為 這裡會 是 一個 垃圾 場
Of course.	是 啊
For decades, you've heard the false rumors:	幾 十年 來 你 們 聽過 這些 錯誤 的 謠傳
"North Korea is a failed state.	北韓 是 一個 失敗 的 國家
We can't feed our people."	我們 不能 養活 我們 的 子民
- Yeah. -It's all propaganda.	- 是 - 那全 是 謠傳
I see. Well, yeah, I mean...	我 知道 了 而且 額 我 的 意思 是
I did see a fat kid	我 確實 看到 了 小胖 孩
and a really nice-looking grocery store.	和 一個 非常 漂亮 的 商店
Oh, we have beautiful grocery stores here in North Korea.	對 在 北韓 我們 有 很多 漂亮 的 商店
You know, one of my favorite things to do	你 知道 嗎 我 最 喜歡 做 的 一件 事
is just strolling up and down the aisles	就是 沿著 廊道 來 回 散步
to see the-the beautiful fruits of my country's land.	看 我們 國家 的 美麗果實
I can believe that.	我能 想像 的 到
It looks like you hit the grocery store pretty often.	看起 來 你 經常去 商店 哦
Screw you, Dave.	去 你 的 戴夫
- Hey, you want to see something cool? -Yeah.	- 嘿想 不想 看酷 一點 的 - 當然
Holy fuck-a-moley!	哇勒幹 他媽 的
Is that real?	這是 真的 嗎
It was a gift to my grandfather from Stalin.	這是 史達林給 我 爺爺 的 禮物
In my country, it's pronounced "Stallone."	在 我們 國家 它 的 讀音 是 史泰龍 ( 藍波 演員 )
You're so funny, Dave.	你 真 有趣 戴夫
Uh, right.	恩對 啊
Well, can we look inside?	那 我們 能 看看 裡面 嗎
Fuck, yeah, we can.	幹當然 能 了
Come on.	來 吧
This is so cool.	太酷 了
- A tank! -Yeah, a tank.	- 坦克 - 是 啊 坦克
Whoa.	哇 哦
Is it still live?	還能 用 嗎
I don't know.	我 不 知道
Maybe we should find out.	也許 我們 應該 試試
Look... you have a... sound system in here?	看 你 有 個 音響 設備
Oh, no, no, no. Don't... d-don't touch.	哦 別別 別別 別動
- Katy Perry? -Oh...	- 凱蒂佩芮 - 噢
Oh, uh... no, my wife must have put that in there,	哦 啊 不 一定 是 我 太太 把 它 放 那裡 的
'cause I've never heard this before in my life.	因為 在此之前 我 從 沒 聽過 這個
I love Katy Perry!	我 愛凱蒂佩芮
Baby, you're a firework Come on,	寶貝 你 就是 一簇 煙火來 嘛
show 'em what you're worth... I love... I mean, I have this on...	給他們 看看 你 的 價值 我 愛我 是 說 我 有 這個
I listen to this all the time.	我 一直 在 聽 這個
- Really? -I love her!	- 真的 嗎 - 我 非常 喜歡 她
You know why I really like her?	你 知道 為 什麼 我 這麼 喜歡 她 嗎
'Cause... because she has such a strong message	因為 因為 她給 全世界 的
for young women and girls across the planet.	青年 女性 和 女孩 兒們 傳達出 如此 強烈 的 信息
She's a... It's so empowering.	她 是 一個 她 天生 就 有 這種 氣質
Yeah.	是 啊
You know, Dave, sometimes I feel like a plastic bag.	你 知道 嗎 戴夫 有 時候 我 感覺 自己 就 像 個 塑膠袋
Drifting through the wind?	在 風中 飄著 啊
Wanting to start again.	想 重新 開始
Oh.	哦
As you shoot across the Sky,	當你射 向 天空 的 時候
sky, sky... Oh, good times.	- 天空 天空 - 哦 好 時光 啊
- Yeah. -Yeah. Uh, Dave?	- 是 啊 - 是 啊 啊 戴夫
Do you think that margaritas are gay	你 覺得 瑪格麗塔酒 是 因為 太甜
because they are so sweet?	而 被 看做 同性 戀 的 特徵嗎
Did someone tell you that? That margaritas are gay?	誰 說 的 喝瑪格麗塔酒 的 人 是 同性 戀
No, it's just a question I have.	不 這 只是 我 自己 的 疑問
If liking Katy Perry and drinking margaritas is gay,	如果 喜歡 凱蒂佩芮 喜歡 喝瑪格麗塔酒 就是 同性 戀
then who wants to be straight?	那 誰 想 做 異性 戀 呢
- Not me. -Boring!	- 一定 不是 我 - 那 就 太無聊 了
Margaritas are great.	瑪格麗塔酒 很棒 啊
And whoever planted that in your head is crazy.	無論 是 誰給 你 腦中 灌輸 這種 思想 的 人 都 是 瘋子
Let me ask you something.	讓 我問 你 件 事
Does this thing still run?	這個 還能 開 嗎
Oh, man, this is great, right?	哦 老兄 這個 太棒了 不是 嗎
Can we fire the gun?	我們 能 開炮 嗎
You think I'd tease you and not take you all the way?	你 覺得 我會 勾起 你 的 興趣 然後不給 你 展示 點真 東西 嗎
- Really? -Close that shit.	- 真的 嗎 - 把 那 玩意 關上
- Closing the hatch. -Okay.	- 關艙門 - 好 的
Boom, boom, boom!	蹦蹦 蹦
Oh, shit!	哦 天 啊
Fuck you, tree!	去 你 的 大樹
The control room will be fully staffed	控制室 需要 配備 好人 員
to insure an uninterrupted transmission.	來 保證 傳輸 的 連續性
All right.	好 吧
This is the kill switch.	這個 是 中斷 開關
During the interview, if any parameters are violated,	在 採訪 中 如果 出現 任何 差錯
I will use it and cut the signal.	我 就 用 它 切斷 信號
Don't worry, we're gonna stick with the program here.	別 擔心 節目 全程 我們 會 一直 在 這裡 的
I will be in charge of every aspect of this transmission.	我 負責 這次 播送 的 所有 方面
Dave and the show itself are very dependent on me	說 到 如何 拍攝 節目
when it comes to how we actually shoot the show.	戴夫 和 這個 節目 本身 很大 程度 上 都 靠 我
I know. I've watched every episode	我 知道 為 了給 這次 採訪 做 準備
in preparation for this interview.	你們 做 的 每 一期 節目 我 都 看 了
Wow!	哇 哦
I particularly enjoyed	我 尤其 喜歡
the Miley Cyrus camel toe episode.	麥莉 塞勒斯 的 駱駝 蹄 那 一期
Oh, the camel toe episode. That was good.	哦 駱駝 蹄 那段 不錯
I've never heard this expression before.	我 以前 從 沒 聽 說過 這種 表達
But after seeing it, it is a perfect	但 在 看過 之 後 就 會 發現
representation of her vagina.	這是 對 她 陰道 一個 超 貼切 的 描述
It is， it looked exactly like that, yeah.	確實 是 看 就 來 真的 很 像是 的
- It's very deep. -Very deep. Yeah.	- 非常 深 - 很深 是 啊
She has quite a hearty moose knuckle.	她 的 緊身 衣正 勾勒 出 她 那 飽 滿 的 私處
You Americans are so creative with your sexual innuendos.	你們 美國人 對 於 性 方面 的 暗喻 還 真是 有 創意 啊
- We do it very well. -Many animal references.	- 還行 - 很多 都 能 用動物 代表
Oh, yes, tons.	哦 是 的 非常 多
Please, take this printed copy of the questions.	請 拿 著 這份 問題 的 打印 版
It's crucial Dave review them before the interview.	有 必要 讓 戴夫 在 採訪 前 復 習 一下
Officers Koh and Yu will now take you	谷長 官 和 於 長 官會 把 你 帶 到
to your room, where you'll be served lunch.	你 的 房間 你 在 那裡 用 午餐
Come, American. Time to get even fatter.	來 吧 美國人 吃 得 更 肥 的 時間 到 了
Oh, ha-ha. Great.	哦 哈哈 太棒了
Thanks, guys.	謝謝 了 伙計們
Making you my little Korean bitch!	讓 你 成為 我 的 北 韓小 跟班
What are you gonna do?	你 要 做 什麼
You gonna drop some nukes on L.A.?	你 打算 往洛杉磯 發射 核導彈 嗎
- Nuke your mama. -I bet they can't even	- 射 你媽 - 我 打 賭導彈 都
make it to Australia!	到 不了 澳大利 亞
Face!	臉
Man, this is so nice.	老兄 這 太棒了
Let me ask you something.	我來問 你 件 事
Now, don't take this the wrong way.	現在別 誤會
You can ask me anything, Dave.	你 可以 問我 任何 事戴夫
Do you pee and poo?	你 小 大便 嗎
You've heard the stories, huh?	你 已經 聽過 那個 故事 了 是 吧
Yes, I pee and poo.	是 的 我 小便 也 大便
So you have a butthole.	那 你 是 有 屁眼 囉
I've got a butthole,	我 有 屁眼
and it's working overtime.	而且 它 一直 有 在 用
You are awesome.	你 真是 太棒了
You know, this is so weird.	你 知道 這 很 奇怪
You are, like, the coolest guy.	你 是 最酷 的 人 了
But a lot of people	但 很多 人
say that...	說
you're bat-shit crazy.	你 是 個 瘋子
They're not wrong.	他們 也 沒錯
I'm 31 years old.	我 才 31 歲
The fact that I am running a country is bat-shit crazy.	就 讓 我治國 這才 是 瘋 了
Hey, what am I to do	嗨當 2400 萬人
when 24 million people	指望 我 做 他們 的 領袖 他們 的 神
look to me as their leader, their god?	我 又 能 怎麼 做 呢
What am I to do when my father's dying wish	我 父親 臨終 前囑 託
was for me to carry his torch?	讓 我 接班 我 又 能 做 什麼 呢
Wow.	哇 哦
You want to know what my father said to me on his deathbed?	你 想 知道 我 父親 在 臨終 前 的 病榻 上 對 我 說 了 什麼 嗎
What did he say, Dave?	他 說 了 什麼 戴夫
"I'm disappointed,	我 很 失望
because you haven't done enough with your life."	因為 你 這 一生 無所 成就
That is fucked up.	那爛 透 了
Yeah, tell me about it.	是 啊 誰 說 不是 呢
Jordan!	喬丹來 了
Oh!	哦
- They call me incompetent. -That's exactly what they	- 他們 說 我 無法 勝任 - 這 正是 他們 所 說 的
- said about me when I scored this interview. -No way.	- 就 在 我 拿到 這次 採訪 時 他們 也 是 這麼 說 的 - 不會 吧
They said, "Dave Skylark is stupid and incompetent."	他們 說 戴夫 的 今晚 史開勒 既 愚蠢 又 無能
You're handsome, competent, suave.	你 很 英俊 有 能力 也 很 文雅
How dare they!	他們 怎麼 能 這麼 說
I pretend like their insults don't get to me.	我 假裝 他們 的 羞辱 並沒有 傷害 到 我
But they do.	但 其 實傷 到 了
You know what's more destructive than a nuclear bomb?	你 知道 比核彈 傷害 更具 毀滅性 的 是 什麼 嗎
Words.	言語
And the people are jealous of men like you and me.	人們 嫉妒 像 你 我 這樣 的 人
It's as though they despise us because they are not us.	他們 好像 是 看不起 我們 那 是 因為 他們 成不了 我們
Hate us 'cause they ain't us.	討厭 我們 因為 他們 不是 我們
Exactly.	沒錯
They hate us because they ain't us.	他們 討厭 我們 是 因為 他們並 不是 我們
- That's a great saying, okay? -Hate us 'cause they ain't us!	- 這個 說法 很棒 有木有 - 討厭 我們 是 因為 他們 並非 我們
They hate us because they ain't us.	他們 討厭 我們 是 因為 他們 並非 我們
Kim! You got it, boy!	金接 好 了 哥們
Okay. Okay. Alley-oop!	好 吧 好 吧 空中 接力
Oh!	噢
- That's all right.	- 沒關 係
- That's all right. -Oh, my ankles.	- 沒關 係 - 哦 我 的 關節 啊
- Okay. -Hey, Kim.	- 好 吧 - 嘿金
Let me ask you something.	我問 你 件 事
Was your father the one who said that margaritas are gay?	是 你 父親 說 喝瑪格麗塔酒 的 都 是 同性 戀 嗎
He said that my brothers and I were all too feminine.	他 說 我 和 我 的 兄弟 們 都 太 娘娘腔 了
That our luxurious lifestyles turned us into homosexuals.	他 說 是 紙醉 金迷 的 生活 讓 我們 變成 了 同性 戀
I don't have to worry about that anymore.	我 再也 不用 擔心 這個 了
Because guess what I get tons of.	因為 你 猜 我 得到 的 最 多 的 是 什麼 ?
Pussy.	女人
Oh, my God.	哦 我 的 天吶
Hey.	嘿
Dude, you just spent the fucking day	老兄 你 一整天
with Kim Jong-un. What happened?	都 和 金正恩 在 一起 都 幹 嘛 了
Ah...	啊
It was amazing.	這 一天 過得 很棒
- "It was amazing"? -Yeah.	- 很棒 - 是 啊
I think it was one of the best days of my life.	我覺 得 這是 我 一生 中 最 棒 的 幾天 之一
- What? -We smoked joints,	- 什麼 - 我們 一起 抽 雪茄
played basketball,	打籃球
fucked chicks.	幹 女人
We had the best margaritas.	還喝 了 最 棒 的 瑪格麗塔酒
Did you say you fucked chicks?	你 是 說 你 幹 了 女人
Oh, my God.	哦 我 的 天 啊
Kim Jong is an animal.	金正恩 就是 個 色鬼
You know you have to kill this fucking guy tomorrow, right?	你 知道 你 明天 就 得 殺 掉 這個 人 對 嗎
I've been thinking a little bit about the mission.	我 也 會 想 一下 這次 的 任務
Okay.	好 吧
America, you know,	美國 你 知道
always puttin' its nose in things and screwin' 'em up.	總是 把 它 的 鼻子 放進 東西裡 聞然 後 把 它 弄 得 一團 糟
The truth is, Kim is a master at manipulating the media.	事實 上 金正恩 是 個 操縱 媒體 的 好手
- Yeah. -You're the media.	- 是 啊 - 你 就是 媒體
You get what's happening here?	你 明白 是 怎麼 回事 了 嗎
Maybe the media's manipulating you.	也 許媒體 正在 操縱 你
"Maybe the media's manip..."?	也 許媒體 正在 操縱
What the fuck does that even mean?	這他媽 到底 什麼 意思 啊
I'm the only one who's spent real time with him, all right?	我 是 唯一一 個 和 他 真正 呆 在 一起 的 人 對 吧
Spent face-to-face time.	我們 面對面
Dick-to-dick.	老二 對 老二
It's just, man, I can sympathize	老兄 我 只是 同情
with people that get dumped on by the media... and it sucks.	那些 被 媒體 拋棄 的 人 那 糟透了
Well, you know what else fuckin' sucks?	呃 你 知道 還有 什麼 也 他媽 的 糟透了 嗎
Concentration camps, famine, firing squads...	集中 營 饑 荒 死刑 射擊隊
I didn't see any here. Have you?	在 這裡 我 可 沒 發現 你 呢
No.	沒有 發現
Your attendance is required in the banquet room	我們 偉大 的 領導 邀請 您
of the Eternal Leader.	到 宴會廳
- Hey, how you doing? -Yeah, seriously.	- 嘿 你 怎麼樣 啊 - 不錯 真的
You are looking fantastic.	你 看 起來 棒極 了
Your unhealthy obsession with my well-being	你 對 我 是否 安康 的 異常 關心
is only making me more suspicious of you two.	只會 讓 我 對 你 們 倆 更加 懷疑
- You don't have to be suspicious. - Oh, no, no.	- 你 不必 懷疑 - 哦 不 不 不
I just want to know what your routine is, man.	我 只是 想 知道 你 的 習慣 老兄
You look fantastic. Do you take vitamins or...?	你 狀態 看 起來 真的 不錯 你 是 吃維 他命 還是
- You're doin' somethin' right. -Yeah, you look good.	- 你 一定 是 做 了 什麼 - 是 啊 你 看 起來 非常 不錯
Do not ask us any more question.	別 再問 我們 任何 問題 了
Meet us in the banquet hall.	我們 在 宴會廳 見 吧
You see how big their guitars are compared to their bodies?	你 看看 和 他們 的 身體 比起 來 吉他 有 多 大 啊
I think it's funny.	我覺 得 這 很 有趣
That is funny.	確實 很 有趣
Oh, no.	哦 不
It's happening.	起 作用 了
Dave.	戴夫
Dave.	戴夫
No.	不是
- Wait, what? -Look at the fu...	- 等等 怎麼 了 - 你 看 那個
They're good.	他們 沒事
Oh, shit. Oh, shit. Oh, shit.	哦 該 死哦 該 死哦 該 死
Caw, caw.	嘎嘎
- What do we do? -He's gonna poo.	- 我們 怎麼 辦 - 他 要 大便 了
- Oh, no. Oh, no. -	- 哦 不是 不是
Oh, shit. Oh, no. Oh, no.	哦 靠 哦 別別
It's happening.	毒藥 起 作用 了
So gross.	好 噁 心
Oh, no, no, no.	哦 不 不 不
- -Oh, no! Oh, no!	- 哦 不 不 不
- Oh, no. Oh, no. -	- 哦 不 哦 不 -
It's okay, man.	沒事 了 兄弟
No.	有事
Come on, man.	振作 下 啊 小伙子
We just killed two innocent men.	我們 剛殺 了 兩個 無辜 的 人
Look, Dave, first of all,	聽著 戴夫 首先 呢
it's not your fault that those men died.	這些 人 死 了 不是 你 的 錯
Second of all, they had to go.	然後他 們 應該 死
They knew we were up to something.	他們 知道 我們 在 策劃 什麼 事
- I'm out. -What?	- 我 不 幹 了 - 什麼
- You cannot pull out of this. -I'm pulling out.	- 你 不能 就 這樣 退出 了 - 我 不 幹 了
- You're way too deep to pull out. -I'm pullin' out.	- 你 已經 不得不 幹 了 - 我 就 不 幹 了
No, you are not. You are leaving it in.	不 ， 你 不能 你 得 繼續 參 與
I been pullin' out for years, son.	我 已 經要 不 幹 好 幾年 了 小子
You are not fucking pulling out of this mission.	你 他媽 的 不能 退出 這次 任務
That's the only reason we're here.	這是 我們 來 這裡 的 唯一 目的
We are doing this!	我們 來 這裡 就是 做 這個 的
Kim is not evil.	金正恩 不是 壞人
He was just born into a hard situation.	他 只是 生在 這樣 一個 苦命 的 環境裡
You are fucking stupid, and you are fucking ignorant, Dave.	你 真 他媽 的 蠢 並且 還他媽 的 無知 戴夫
- Mm! -Ugh!	- 嗯 - 呃
- Who you calling ign'ant? -You, motherfucker.	- 你 說 誰 無知 呢 - 你 這個 混帳 東西
You're fuckin' arrogant.	你 真 他媽 狂妄自大
Everything he's shown you is fake.	他給 你 看 的 所有 東西 都 是 假 的
He's shown you what you want to see.	你 讓 你 看 你 想 看到 的
He's fooled you, you fucking idiot!	他 在 愚弄 你 你 個 蠢貨
God, look how ready you are to betray me.	天 啊 看看 你 那 要 背叛 我 的 樣子
This whole time I thought you were Samwise to my Frodo.	一直 以來 我 都 認為 你 會 像 山姆 衛斯 對 待 佛羅多 一樣 對 待 我
But you're just Boromir.	沒 想到 你 就是 個 波羅莫 ( 被 魔戒 誘惑 )
I don't know who the fuck that is.	我 才 不 知道 那 是 什麼 鬼 東西 呢
"I don't know who Boromir is."	我 不 知道 波羅莫是 誰
That's such a Boromir thing to say.	這 就是 波羅莫 那樣 的 人 說 的 話
This is fuckin' done.	這件 事 他媽 就 快完了
You are fuckin' done after this.	做 完 這件 事 你 他媽 的 就 完事 了
Once you kill this motherfucker, this shit's over.	只要 你 殺 那個 混蛋 東西 這件 爛事 就 完 了
But you are going to kill him!	但是 你 得 去 殺 了 他
You've just turned me into a gun, and you're pointing me	你 把 我 變成 了 一把 槍現 在 你 又 要 把 我 這把 槍 指向
at the one guy who actually gets me.	那個 打動 我 的 心 的 人
Well, you know what, cowboy?	好 吧 你 知道 嗎 牛仔
A gun can't fire without no bullets.	一把 沒有子彈 的 槍 是 開 不了 槍 的
What the fuck are you doing?!	你 他 媽要 干什麼
- No, no, no, no, no, no! -Yes, yes! Yes, yes!	- 不 不 不 不 不 不 不 - 就要 就要 就要 就要
Do you realize what you just did?	你 知道 你 剛才 做 了 什麼 嗎
I just saved a life, you murderer.	我救 了 一個 人 的 命 你 個 殺 人犯
- You piece of fu... -Mr. Skylark.	- 你 個 - 史開勒 先生
The Supreme Leader requests your presence	最高 領導人 要求 你 出席
at a restaurant in Pyongyang for dinner.	平壤 一家 餐廳 的 晚餐
He will be at your door in 30 minutes.	他會 在 30 分鐘 內過 來 接 你
Hey, Dave.	嘿戴夫
Thank you for being with me in my time of sorrow.	我 悲傷 的 時候 很 感謝 你 能 和 我 在 一起 在
That was super-gross and fucked-up.	那 真是 非常 噁 心且 一團 糟
Hi.	你好
Uh, Mr. Supreme Leader.	額 最高 領導人 先生
I'm Aaron.	我 是 艾倫
- Aaron? -Hello.	- 艾倫 - 你好
Uh, we never got a chance to formally meet, Mr. Great Leader.	呃 我們 還沒有 機會 正式 見 面偉大 的 領導人 先生
I just wanted to shake your hand.	我 只是 想 和 你 握個 手
Well, any friend of Dave is a friend of mine.	好 吧 戴夫 的 朋友 就是 我 的 朋友
Uh-huh.	噁 哼
No!	不
- Don't shake that hand. -Why not?	- 不要 和 他 握手 - 為 什麼 不
Yeah, why not?!	對 為 什麼
Because Aaron's a Jew.	因為 艾倫是 猶太人
- Oh, gross. -Let's go, Supreme Leader.	- 哦 噁 心 - 我們 走 吧 最高 領導人
Okay. It was nice meeting you.	好 的 很 高興見 到 你
Don't you know Jews are bad luck?	你 不 知道 猶太人會 帶賽 嗎
Fuck you, fuck you!	幹 你媽 的 幹 你媽 的
Friends don't kill friends' friends.	是 朋友 就 不要 殺 朋友 的 朋友
Okay. Okay.	好 吧 好 吧
Oh, fuck.	哦 幹
Mr. Rapoport, we need to review some new data	雷特波 先生 我們 需要 回顧 一些 在 明天 的 採訪 中
the Leader wants included in tomorrow's interview.	領導人 希望 包括 在 內 的 新 的 數據
Now's not really the best time.	現在 真 不是 時候
It will only take a moment.	這 只要 耽擱 一點 時間
Yeah, okay.	哦 好 吧
- Great. -Thank you.	- 很 好 - 謝謝 你
Would you like to share a drink?	喝一杯 怎麼樣
Raise your glasses.	舉起 你 們 的 杯子
Koh and Yu!	谷 和 於
Koh and Yu possessed the finest trait men can have	許和 於 擁有 一個 人能 擁有 的 最好 的 特質
Loyalty.	忠 誠
I know how you feel. My dog Digby died	我 知道 你 的 感受 在 我 還小 的 時候
when I was a kid, and I'm still fucked up about it.	我 的 狗 死 了 到 現在 想起 這事 我 還是 感覺 難受
Loyalty is what made my father	是 忠 誠 讓 我 父親
and grandfather so successful.	和 爺爺 變得 這麼 成功
That's right. Listen up. Hey, listen up. You.	這是 對 的 聽 好 了 嘿 你 聽 好 了
Without loyalty,	沒有忠 誠
a country is a lawless jungle.	一個 國家 就是 沒法紀 的 叢林
Welcome to the jungle, baby. Welcome to the jungle.	歡迎 來 到 叢林親 愛的 歡迎 來 到 叢林
On your sh-n-n-n-n-n-n knees.	用 你 們 的 小 短腿
How else can I prevail against so many enemies?	如何 才能 打敗 這麼 多 的 敵人
Defectors.	背叛者
South Korean capitalists.	南 韓資 本家
The people in this room...	在 這個 房間裡
who don't think I can fill my father's shoes!	認為 我 不能 很 好 的 接替 我 的 父親 的 人
These bastards deserve no humanity!	這些 雜種 就 不 應該 用人 道 對 待
To those who seek to undermine me,	對 於 這些 在 國內 國外
at home and abroad,	想 搞垮 我 的 人
I cannot respond with anything less	我 將用 我 的 全部 實力
than the totality of my strength!	來 回應 他們
If a billion people across the Earth and in my own country	如果 在 這個 地球 上 和 我的國 家中 有 上 億 的 人
must be burned to prove it	必須 被 燒成 灰燼 來 證明 這一點
then my worthiness as a Kim	那麼 我 作為 金姓 一族 的 價值
will be demonstrated!	將會用 此展現
Um...	呃
Hey, Kim, I gotta go outside.	嘿金 我 需要 出去 一下
Is that okay? I'm just feelin'...	可以 嗎 我 只是 感覺 喝 了
Too much, uh, s-s-soju, whatever.	太多 呃 燒酒 什麼 的
Okay.	好 的
I'll be back.	我 過會兒 回來
So how'd you wind up as one of the heads	那麼 你 是 怎麼樣 成為 政府
of a, uh, dictatorship?	的 領導人 之一 的
Ah.	啊
One day, party officials came to my classroom	有 一天 黨 的 官員來 到 我們 班上
in search of a young woman	找 一個 年 輕 的 女孩
to serve on the Kim family personal staff.	去作 金家 的 私人 侍從
They selected me.	他們 選擇 了 我
Over the years,	過了 幾年
I grew close with Kim Jong-un.	我 在 金正恩 身邊 長 大
When he rose to power, he took me with him.	當他 當權 的 時候 他 帶 上 了 我
And here I am.	成就 了 現 在 的 我
Kinda have a guy like that in my life, too.	在 我 的 生活 中 也 有 個 那樣 的 人
You've been with Dave a long time.	你 跟 著 戴夫 很 久 了 吧
He's a hard guy to leave.	他 很 難 讓 人 離開
You just like the money and can't say no to Dave.	你 就 向 錢 一樣 無法 對 戴夫 說 不
No...	沒有
Yes! I know you.	是 的 我 知道 的
You're fuckin' awesome.	你 真 他媽 的 了不起
- No, I don't understand you. -And it's a little bit weird.	- 不 我 不 懂 你 在 說 什麼 - 有點 奇怪
I mean, do you have a boyfriend in this country?	我 的 意思 是 你 在 這個 國家 有 男朋友 嗎
Is that too forward of me to ask?	還是 說 我問 的 太 直接 了 呢
What are you lookin' at?	妳在 看什麼
- I should leave. -Why?	- 我 得 走 了 - 為 什麼
I'm concerned my feelings of attraction for you	我 擔心 我 對 你 產生 的 感情
will cause me to make mistakes.	會 讓 我 犯錯
Your feelings of attraction for me?	你 對 我產生 了 感情
Fuck this!	管 他 的
Ever since I saw you on that mountaintop,	從 我 在 那個 山頂 上 看到 你 的 時候 起
this is all I've been thinking about.	這就 一直 想 這樣
Me, too.	我 也 是
Fake.	假 的
Fake carrots.	假羅波
Fake fruit!	假 水果 ！
Fake!	假 的 ！
Fake!	假 的 ！
Fake grapefruits!	假 柚子 ！
Fake!	假 的 ！
Liar!	騙子 ！
You liar!	你 這騙子 ！
Why aren't I naked yet?	你 怎麼 還不把 我 脫光 ？
Uh...	呃 …
- Aah! -Yeah.	- 啊 - 爽 ！
You're hairy, you're so hairy like a bear!	好多 毛毛 多得 活像 頭熊 ！
You're fucking sexy, yeah.	你 真 他媽 性感 啊
Your nipples are so pink!	你 奶頭 居然 這麼 粉
Yes, they are.	是 啊 的確
I love it!	愛死 了
Okay, no, whoa, no!	好 吧 我 擦 別
- No hands. -No hands?	- 不能 用手 - 不用 手
I'm not into handsy shit.	我 不 喜歡 用手
That's how I like it.	我 都 這樣 的
Well...	那 …
Just take it off.	脫掉 它
Okay.	好 吧
You said no hands!	你 說過 不用 手 的
You fucking hit me with your hand!	那 你 他媽 還用 手巴 我
How do I get it off?	你 叫 老子 怎麼 脫
Use your big, fat American teeth.	用 你 的 美國 大肥牙 咬 開 啊
Okay, I will!	好 的 我 試試
This is awesome.	真贊 啊
Oh, this is hard.	擦 好 難 弄 啊
Shit...	媽的
Oh, shit, what's wrong?	哦 天 啊 怎 了
The numbers I gave you on potato output...	我給 你 的 那 組馬鈴薯 的 數字
are exaggerated.	都 是 被 誇大 的
That's okay with me. I don't really care about that.	沒關 係 我 根本 不在乎 的
If you want, you can give me	你 願意 的 話 你 可以 給我
the real numbers, and we can get back	那組 真實 數字然 後 我們 回到
- to what we were doing. -No, it's not just the numbers.	- 剛才 進行 到 的 地方 - 不 ， 不 只是 數字 的 事
I am a terrible person.	我 是 個 糟糕 的 人
No, you're not. You're the best person.	不會 啊 你 是 最好 的 女人
You were about to have sex with me.	你 不是 要 跟 我 做 愛麼
That's like the best thing someone could do.	這 就是 大家 可以 做到 的 最好 的 事 啊
I'm the propagandist of a totalitarian dictatorship.	我 是 個 專制 獨裁 政權 的 宣傳者
That's an area you could improve,	妳在 這 方面 可以 改善
but, you know, you don't have to dwell on it or anything.	但 這些 事 你 不必要 去 想 太多 懂麼
He's as cruel as his father and grandfather before him.	他 跟 他 爹 還有 他爺 一樣 殘酷 無情
You knew this this whole time.	這些 東西 你 從 來 都 知道 啊
Why is this just bothering you now?	怎麼現 在 讓 你 這麼 糾結
It's been bothering me for a long time,	我為 這個 糾結 很 久 了
and I'm not the only one,	我 也 不是 唯一一 個 這麼 糾結 的 人
but too many people see him as a god.	可太多 人 把 他 奉若神明
How do you prove to 24 million people	你 怎麼 向 那 兩千 四百 萬人 證明
that their god is a murderer and a liar?	他們 的 神明 是 個 殺 人 放火 的 騙子
Aaron, I need to talk.	艾倫 我 得 跟 你 談談
Fuck, it's Dave... shit.	我 靠 是 戴夫媽 的
You, you hide in there, I'll be back.	你 你 躲 在 這我 一會 就 會 回來
- I'll go deal with him. -Okay, go, go, go...	- 我會 應付 他 - 好 的 快 去 快 去
Oh, shit.	哦 該 死
- Aaron, are you here? -Yeah, one sec, uh, one sec.	- 艾倫 你 在 麼 - 在 稍 等 一會 稍等一下
- One sec... don't come in, don't come in! -I need to talk.	- 馬 上別 進來 千萬別 進來 - 我 需要 和 你 談談
Hey, how's it going, dude?	嘿 進展 如何 了
- Not good. -Uh, maybe now's	- 不太好 - 嗯 也 許現 在
not a good time, maybe we should take a walk.	不是 一個 好 時機 也 許我們 應該 出去 走走
No, no, no, no, I can't walk this off.	不 不 不 我現 在 不想 走走
I cannot walk this off.	我現 在 不想 走走
I need to...	我 需要
I'm so fucking pissed.	我 他媽 的 要 氣炸 了
I just want to hit something!	我 只是 需要 找個 東西出 出氣
No, no!	哦 不 不
No, don't punch anything!	別 不要 打 任何 東西
Breathe.	放 鬆
Just breathe, maybe pace it out.	放 鬆 吸 氣 吐 氣 也 許 就 能 好 點
Fuck, man.	媽的 幹
Kim.	金正恩
- Wha-What about him? -He's going crazy.	- 那 那 金正恩 怎麼 了 - 他 要 瘋 了
He said he's going to blow up the world	他 說 他 要 炸掉 整個 世界
just to show that he's the shit.	僅僅 是 為 了 炫耀 他 是 個 混蛋
And at first, I thought,	剛開始 我 覺得
"All right, maybe he's just talking, you know,	" 也 許他 也 就是 說 說 而已 你 懂 的
maybe he doesn't mean it."	也 許他 不是 認 真的 "
Then I saw this fake fucking grapefruit.	可是 後 來 我 看到 了 個 假 的 葡萄柚
What?	什麼
All the food in that grocery store is fake!	所有 在 水果店 的 水果 都 是 假 的
He fucking lied to me.	他 他 娘 的 把 我 耍 了
Maybe that, maybe that fat kid isn't fat.	也 許也許 那個 胖 小孩 並 不是 真胖
I mean, oh, what about the concentration camps?	我 是 說 噢 那 集中 營呢
And the famine... maybe that's real.	還 有 饑 荒 萬 一 那 是 真的
God!	天吶
It is... I've been telling you that for weeks now.	就是 真的 三周 來 我 一直 在 不停 地告訴 你
He fucking honeydicked me.	他 耍 了 我
He honeydicked the shit out of me.	他 他媽 的 把 我 耍 得 像 猴 似的
- Sucks. -You still got that poison?	- 該 死 - 你 還有 那個 毒藥 嗎
- You can't speak? -What the fuck?	- 你 說 不 出話 來 了 嗎 - 你 他 娘 的 要 干 啥
I want to know if you have the fucking poison	我 想 知道 你 是否 還有 那個 該 死 的 毒藥
- so we can kill that motherfucker. -What?!	- 然後我們 可以 殺 了 那個 狗 娘養 的 - 你 說 什麼
Whoa, ho, spy! What the hell?!	噢 間諜 三小情況
- She's on our side! -What's going on here?!	- 她 是 我們 這邊 的 - 這他媽 的 是 搞 毛 啊
- You can trust me, I'm okay. -You can trust her, man!	- 相信 我 我 不是 間諜 - 你 可以 相信 她
Trust her?! Are you joking?! We got to kill her.	相信 她 你 腦殘 嗎 我們 得 殺 了 她
- Oh, my God, what are you doing? -Dude, I was in bed with her!	- 哦 天 啊 你 要 幹 嘛 - 嘿 我 和 她 上床 了
- What?! -We're hooking up.	- 什麼 - 我們 對 上 眼 了
- That's why she's here. -What?!	- 所以 她 才 會 在 這 - 什麼
Let him go; everything is fine.	放開 他 沒事 的
Now we got to kill the girl that you like.	那現 在 我們 得 殺 了 你 喜歡 的 這個 女孩
This is the worst moment ever!	這簡直 是 糟糕 透頂
We're not killing her!	我們 不能 殺 了 她
- She's loyal to Kim. -No!	- 她 是 效忠 於 金正恩 的 - 不要
Dude, she was just telling me she's with us.	喂 她 剛剛 告訴 我 她 要 和 我們 一邊
I hate Kim.	我 恨透 金正恩 了
He is a terrible leader.	他 是 個 糟糕 透頂 的 領導人
- See? -Okay.	- 你 看 - 好
She can help us kill him.	她 能 幫 我們 殺 了 金正恩
What? No, no, no killing.	什麼 不 不 不是 殺 了 他
Kim must die.	金正恩 必須 得 死
That's the American way.	那 是 美國 的 作風
How many times can the U.S. Make the same mistake?	你們 美國 到底 想重 復 幾次 這樣 的 錯誤
As many times as it takes.	多少 次 都 願意
Killing Kim won't change anything.	殺 了 金正恩 改變 不了 任何 事
You said it yourself.	那 是 你 說 的
We got to do something, right?	我們 得 做點 什麼 對 吧
He will be replaced.	他 的 位置 會 被 接替
He has brothers, he has other generals.	他 還有 哥哥 他 還有 其他 的 將軍們
The people need	人們 需要
to be shown that he is not a god,	知道 他 不是 神
that he is a man.	他僅僅 是 一個 普通 的 人
Then they will be ready for change.	然後人們 才能 準備 好 迎接 改變
Yeah, how?	是 啊 怎麼 做
Interviewing him.	採訪 他
Everyone in North Korea will be watching.	北韓 的 每 一個 人 都 會 看到 現場 直播
No... the interview's scripted.	哦 不 採訪 都 是 預先 準備 好 問題 的
His people are never going to let me ask real questions.	他 的 人絕 對 不會 允許 我問 真正 的 問題
Dave, I am his people.	戴夫 我 是 他 的 人 之一 啊
She controls the broadcast.	她 掌管 全北韓 的 廣播 電視 臺
I can't do political interviews.	我 做不了 政治 採訪 節目
I do entertainment interviews.	我 做 的 是 娛樂 採訪 節目 啊
Dude, you can fucking do this.	哥們 你 這次 絕對 他媽 的 能 做好
- Yeah? -Yeah, you don't interview with your brain.	- 真的 - 真的 你 不 需要 動腦子 去 採訪
You interview with your heart.	你 用 你 的 心去 採訪
- True. -Your emotion, Dave.	- 真的 麼 - 用 你 的 情感 戴夫
You get Kim Jong-un to fucking cry like a baby	你 要 讓 金正恩 在 全體 北韓 人民 面前
in front of all of North Korea?	哭 的 像 一個 小屁孩
They'll know he's not a god.	他們 就 會 知道 金正恩 不是 神
- I think I can do this. -You can do it.	- 我 想 我 能 做到 - 你 可以 的
I'm Dave Skylark and I can interview anyone.	我 是 戴夫 • 史開勒 我 能 採訪 任何人
Yeah, you can.	是 的 你 可以
Let's take this motherfucker down!	我們 來 搞 死 這個 王八蛋 吧
Oh, God, oh, God! Oh, ah!	哦 上帝
You got a lot of pent-up energy! -	妳 被 壓抑 太久 的 能量 一次 爆發 啦
Oh, God!	哦 天 啊
Okay, everything's ready.	好 了 ， 一切 都 準備 好 了
Uh, you ready to rock?	噁 你 準備 做 一場 精彩 的 表演 了 麼
Y-You memorize all those facts?	你 你 記住 所有 的 事實 了 嗎
I'm ready, baby.	我 準備 好 了 寶貝
Great.	太棒了
How many people in concentration camps?	集中 營裡 有 多少 人
200,000.	20 萬
How many people malnourished?	多少 人 是 營養 不良
16 million.	1600 萬
They spent $800 million on nukes last year	去年 他們 在 核武器 上花 了 8 億 美元
and got $200 million in food aid from the UN.	而且 從 聯合國 獲得 了 2 億 美元 的 食品 援助
And I got more where that came from, baby.	我 還會 知道 更 多 的 消息 寶貝
Really good... you're going to nail this shit.	真是 太好了 你 要 揭發 這個 人渣
- I just wish we had a fucking escape plan. -Why don't we go	- 我 只是 希望 我們 有 一個 他媽 可靠 的 逃跑 計劃 - 為 什麼 我們 不 去 日本
- to Japan? -Well, 'cause it's across the Sea of Japan.	- 呃 因為 中間 隔 著 日本海
- Why don't we swim? -Can't swim that.	- 為 什麼 我們 不 游泳 去 - 游不過 去
- Oh, I'm a good swimmer. -It's really, really far.	- 哦 我 游泳 很 厲害 的 - 真的 真的 很遠
- People have done it. -Nope.	- 有人 游過 - 沒有
- Yep, Michael Phelps did it. -That's not true.	- 是 的 菲爾普斯 做到 了 - 放屁
- -Okay. -Okay.	- 好 吧 - 好 的
Skylark, two-minute warning.	史開勒 先生 還有 兩分鐘
Just keep me on the air as long as you can.	只要 盡 你 所 能 讓 我 直播 久點
I will, man.	我會 的 兄弟
Maybe we won't get out of here.	也許 我們 會 逃不出 去 這裡
No, we might die.	是 的 我們 可能 會 死
I've had a great life.	我 擁有 一個 精彩 的 人生
I had the best best friend.	我 擁有 最好 最好 的 朋友
Fucked more women than Ellen DeGeneres.	幹 的 女人 比艾倫 • 狄 珍妮 還多
And now it's time	而現 在 是 時候
for the North Korean people to get their dicks wet.	該 讓 北韓 人民 也 濕 了 馬 眼 了
This is a perfect ending for the tell-all.	這是 全盤 揭秘 的 完美 結局
As the two best friends stared each other in the eyes,	當兩個 最好 的 朋友 友 互相 盯 著 對方 的 眼睛
they knew that this might be	他們 知道 這 可能 是
the end of the long road,	長 路 的 盡頭
but they also knew	但是 他們 也 知道
how much they meant to each other, and even though	他們 對 對方 意味著 什麼 而且 即使
neither one could say it out loud,	沒有 人大 聲說 出來
they were both thinking...	他們 都 是 這樣 想
I love you.	我 愛 你
Okay, man, you got this.	好 的 ， 兄弟 有 我 呢
Okay.	好 的
Showtime.	表演 時間
Dave.	戴夫
Kim.	金 先生
Are you ready to share with the world	你 準備 好 向 世界 分享
that gorgeous smile of yours?	你 燦爛 的 笑容 了 嗎
Tonight, I think it's your smile they want to see.	今晚 我想 他們 想要 看 的 是 你 的 笑容
I have something for you.	我 有 東西給 你
What?!	什麼
What's this?	這是 什麼
Open.	打開 吧
Aw... aw!	哇
For me?	給我 的
For you.	給你 的
Oh! Oh! Oh! Oh...!	噢 噢 噢 噢
Oh, he's just like Digby.	噢 他 就 像 迪格 比
Just like Digby.	就 像 迪格 比
I think I'm gonna die.	我 想 我 要 幸福 死 了
- Oh, my God... -Don't die, please.	- 噢 我 的 天 - 拜 託 不要 死 啊
Not till after the interview.	至少 要 到 訪談 結束 再 死 啊
This dog is killing me with cuteness.	這只 狗 可愛死 了
- He's crazy cute. -Can I keep it?	- 他 是 超級 可 愛 - 我能 擁有 它 嗎
Take him home, forever and ever.	帶 他 回家吧 永遠永遠
Why?	為 什麼
I live a lonely life, Dave...	我過 著 孤獨 的 生活 戴夫
and it warms my heart to know	而 有件事 溫暖著 我 的 心
that there is someone in this world	就是 知道 世上 有人
with whom I can truly be myself.	能 讓 我 做 真正 的 自己
Whatever they say about you...	無論 別人 怎麼 說 你
they're wrong.	他們 都 錯 了
I'm just me and I do my best.	我 就是 我 而且 做 最好 的 自己
You're my brother.	你 是 我 的 兄弟
You're my brother.	你 是 我 的 兄弟
Let's get this out of the way, okay?	我們 先 不管 這些 好 嗎
- Okay. -Okay.	- 好 的 - 好 的
And what are we gonna name you, huh?	我們 該 怎麼 稱呼 你 呢 啊
You need a name? Yes, you do.	你 需要 一個 名字 是 的 你 需要
Look, look. He looks just like Digby.	看看 他 看 起來 像 迪格 比
You gotta be fucking kidding me.	你 一定 在 跟 我 開 玩笑 的 吧
We see you in a minute. Bye-bye.	我 很快 會 再 見 你 拜拜
- Okay... -Okay.	- 好 的 - 好 的
- Shall we begin? -Are you ready?	- 我們 開始 吧 - 你 準備 好 了 嗎
Shut the fuck up.	他媽 的 閉嘴
Guys, it's starting! It's starting.	大家 要 開始 了 要 開始 了
And we're on in five...	我們 倒數 五秒
four, three...	四三
Good evening.	晚上 好
And good morning to our viewers around the world.	全世界 的 觀眾 朋友 們 早上好
I'm Dave Skylark.	我 是 戴夫史 開勒
Thank you for joining me for this historic moment in history.	謝謝 你 們 和 我 一起 見證 這個 歷史性 的 時刻
I'm with President Kim Jong-un	在 我 旁邊 的 是 北韓 民主 主義 人民 共和 國的
of the Democratic People's Republic of Korea.	金正恩 主席
We are broadcasting	我們 正在 平壤 外 的
from a station outside of Pyongyang	一個 發射 臺 為 你 報道
for this very special edition of:	這個 特別 版本 的
"Skylark Tonight."	今晚 史開勒
Thank you for joining me,	感謝 你 的 參加
President Kim Jong-un.	金正恩 主席
It is my pleasure, Dave.	我 很 榮幸 戴夫
You know, there is so much misunderstanding	你 知道 外界 對北韓
about North Korea	有 那麼 多 的 誤解
and, uh, me personally.	並且 呃 從 我個 人來 說
- Mm-hmm. -And I can't think of a man	- 嗯 呢 - 我覺 得 想不出 還有 誰
with greater intelligence than you.	能比 你 更 有 才 華 了
I am grateful	我 對 這次 機會
for this opportunity for my government	為 我 的 政府 也 為 國際 社會
and for the international community	創建 一個 更好 的關 係
to forge a better relationship.	表示 深深 的 感謝
So you want to set the record straight.	所以 您 想 糾正 誤解
Indeed, Dave.	正有此意 戴夫
Camera three.	三號 攝像機
Tensions between your nation	貴國 和 南 韓之間 的 兩國關 係
and South Korea are at an all-time high.	局勢 一直 很 緊張
It's fair to say that you're on the brink of armed conflict.	甚至 用處 在 戰爭 邊緣 來 形容 也 不 為過
So, what I want to know is:	所以 我 想 知道 的 是
In these times of great stress,	在 這段 高壓 時期
do you do karaoke?	您 還唱 卡拉 OK 麼
Yes, I do, Dave.	我 唱 戴夫
I believe that it is important for those in power	我 堅信 對 於 掌權 高層 來 說
to remain in touch with the beauty in life.	與 生活 中 的 美好 保持 接觸 是 很 重要 的
I believe that it is important for those in power	我 堅信 對 於 掌權 高層 來 說
to remain in touch with the beauty in life.	與 生活 中 的 美好 保持 接觸 是 很 重要 的
You are also a very accomplished painter, aren't you?	您 也 是 一位 非常 有才華 的 畫家 是 嗎
Well, how can I not be?	我無法 抵抗 藝術 的 魅力
He's reading the scripted questions.	他 正在 念 稿子 上 的 問題
He lulls them and then he gets them.	他 先哄著 他然 再 牽著 他 鼻子走
It's his technique.	這是 他 的 絕活
The beauty guides you.	生活 中 的 美好 引領 著 您
It guides my hand.	它 引領 著 我
This is fuckin' bullshit.	真 他媽 胡扯
Let's take it to a serious tip.	我們 談 一個 嚴肅 的 話題
Supreme Leader Kim, when...	偉大 的 金 領袖
the United States,	當美國
which has an enormous stockpile of nuclear weapons,	這種 擁有 大規模 核武器 的 國家
insists that countries like yours have none,	堅持 認為 像 您 們 這樣 的 國家 並未 持有 核武器 時
does that feel hypocritical to you?	這種 論調 您 覺得 虛偽 嗎
Many Americans do not realize	許多 美國 人並 沒意識 到
that the war in North Korea	在 北 韓發生 的 戰爭
was entirely the fault of the United States.	完全 是 美國 政府 的 錯誤
Damn! Kim's callin' us out!	媽的 金正恩 挑釁 我們
- You really are still hopeful? -No, no, I'm not	- 你現 在 還抱 希望 嗎 - 不了
hopeful at all. He's totally bailed on the plan.	我 一點 也 不 抱 希望 了 他 徹底 放棄 我們 的 計劃 了
America, what you done to these Koreans?	美國 佬 你 對 這些 北 韓人 做 了 什麼
This is a little embarrassing.	有點 小 尷尬
So when you think of all that your country has been through...	所以 當你 想到 你 的 國家 經歷 的
the wars, the floods	戰爭 洪水 所有 這些 災難 時
do you think that your people should be rewarded	你 覺得 你 的 人民 應該 為 他們 的 堅韌 和 力量
for their resilience and strength?	而 受到 政府 的 褒揚 嗎
Of course, Dave.	當然 戴夫
Then why don't you feed them?	那 你 為 什麼 不給 他們 食物
- -Hmm.. -Mm...	- 恩 - 唔
I...	額 我
Camera two.	二號 攝像機
I... beg your pardon?	你 能 再 說 一遍 麼
Why don't you feed your people?	你 為 什麼 不 讓 你 的 人民 衣食 無缺
They are hungry.	他們 正 飽 受 饑 餓
Specifically, two-thirds of them?	確切 來 說 他們 中 的 三分之二 都 在 挨 餓
Isn't that a little embarrassing, since you're	既然 你 是 他們 支柱 或是 說 你 是 他們 的 神
the one they view as a provider and a god?	您 有 沒 有 一點 小 難堪 呢
And you spend $800 million on nukes every year?	你 每年 花 8 億 美元 用作 核武器 的 資金
And you have 16 million people	你 有 一千六百 萬 的 民眾
who are starving?	在 挨 餓
Are you sure you don't, uh...	你 確定 你 不要
mean to ask me about potato yields?	問問 我馬鈴薯 田之類 的 是 事
No, I want to know	不 我 想 知道
about that other thing I just asked.	我 剛才問 的 事情
Okay, uh, well, uh...	好 的 嗯 呃
Dave, as you have seen for yourself	戴夫 正如 你 親自 看到 的
we have a great bounty of food in North Korea.	我們 有 很多 的 糧食
What I saw for myself	我親 眼看 到 的 是
was a fake grocery store	一個 假 的 胖 小孩
with a fake fat kid planted right in front of it.	站 在 一個 假 的 食品 雜貨店 門前
Okay, uh, this is, uh...	好 吧 額 嗯
an offensive line of questioning.	這些 問題 太 失禮 了
I don't think it's offensive. I think it's super important.	我 不覺 得 這無禮 我 覺得 這 很 重要
Obviously, if you don't want to answer these questions,	如果 你 不想 回答 這些 問題
you can just get up and walk away.	你 可以 直接 站 起來 然後走 出去
I can't keep you from retreating.	我 又 不能 把 你 拉 回來
- He's gonna go for the button. -He's not. He's sitting there.	- 他 要 按 那個 按鈕 了 - 他 沒 有 他 在 那 坐 著 呢
- He's not moving. -He's going for the button.	- 他 沒動 - 他 就要 按 了
He's going for the button, he's going for the button...	他 要 按 了 他 要 按 了
He's not. Oh, shit. He's making a move!	他 沒 有 幹 靠 杯 他 要 按 了
Don't move, homie!	別動 蠢貨
Get your hand away from there! Get over there!	把 你 的 手遠離 操作 臺 抬手
Over there!	滾 開點
Get over there!	滾 開點
I will cap you!	我會 盯死 你 的
I'm exploding with energy.	我 抑制 不住 情緒 了
I can't believe this is happening.	我 不敢相信 真的 發生 了
I feel so alive right now. This is so real.	我現 在 感覺 如此 的 有 活力 這太真實 了
He's got him. Nice!	他 搞 到 他 了 幹 得 好
- Dave! Dave... -I know you, Kim.	- 戴夫 戴夫 - 我 了解 你 金正恩
Dave...	戴夫
perhaps the question you should ask is:	也許 你 應 該問 的 問題 是
How have I managed to keep my country so well-nourished	在 美國 對 北韓 施加
despite the harsh and unjust economic sanctions	如此 嚴酷 的 和 不 公平 的 經濟 制裁
imposed on North Korea by the United States?	我 是 怎麼樣 讓 我 的 國家 保持 營養 良好 的
Sanctions? Uh...	制裁 嗯
Don't you know that the United States	你 不 知道 美國
has more incarcerated people per capita than North Korea?	比北 韓有 更 多 的 人進 監獄 嗎
- No. But... -So, perhaps, now,	- 是 啊 但是 - 所以 也 許現 在
you would like to return	你 也 許會 希望 回到
to the civil discussion we had originally agreed upon.	我們 事先 達成 的 討論 討論 議題 上 來
- Uh...	- 額
-No! -	不
Oh, shit! Go to camera one!	哦 幹 轉到 一號 攝影機
Camera three! Camera three!	三號 攝影 機三號 攝影機
Do not move, homie!	別動 低能
Give me something! Give me fucking something!	給我來 點什麼 快 他 媽給 我 來點 止血 的
Okay...	好
Why?!	幹 嗎 啊
Fuck! Shit, that hurts!	幹靠 腰 啊 痛死 了
We don't have concentration camps, Dave.	我們 沒有 集中 營戴夫
Have you seen one person mistreated	你 到 這以 後
since your arrival here?	可 曾 見過 一個 人 受到 虐待 嗎
Oh, shit! Someone's coming.	見 鬼 有人 要來 了
Someone's coming.	有人 要來 了
Oh, fuck! Fuck!	草草
Dave, unless you can show me a person, a photo	戴夫 除非 你 能 讓 我 看到 某個 人
of widespread hunger...	或是 一張 餓殍 遍野 的 照片
Aaron!	艾倫
Do not fuck with my angles!	別亂 搞 攝影機 的 角度
Oh, shit! Oh, shit!	喔 幹 ! 喔 幹 !
You're fucking up the angles!	你 他 媽亂 搞 攝影機 的 角度
Sit still!	給 老子 坐 好
Go wide, camera two!	拉遠視 野二號 攝影機
Slow push!	慢慢 推進
Thank you!	謝謝
Face it, Dave, you have failed.	面對 現實 吧 戴夫 你 失敗 了
You've made wild allegations but you have proven nothing.	你 胡亂 的 指控 可 你 什麼 都 證明 不了
You made this long journey	你 經歷 了 如此 長 的 旅途
just to show the world that they were right about you.	只是 告訴 世界 他們 對 的
You are incapable of conducting a real interview.	你 根本 就 做不了 真正 的 採訪
You're a joke!	你 就是 個 笑 話
Maybe you're right.	也許 你 是 對 的
Yeah, it sucks.	是 的 採訪 糟透了
Because I need people's approval.	因為 我 極度 需要
Desperately.	民眾 的 認可
Because I could never get it	因為當 我 還小時
from my father when I was a kid.	就 得不到 父親 的 認可
But I see a lot of the same thing in you, Kim.	但是 我 在 你 身上 看到 了 許多 一樣 的 事情 金正恩
Your father...	你 的 父親
deprived you of life's simplest pleasures.	剝奪 了 你 生活 中 再 簡單 不過 的 快樂
He told you that margaritas are gay.	他 告訴 你 同性 戀才 喝瑪格麗特
I have no comment on margaritas.	我 對 於 瑪格麗特 沒有 特別 想法
Then why don't you drink them?	那 你 為 什麼 不 喝 呢
I... don't like brain freeze.	我 不喜 歡大腦 不 清醒
Fuck you, Dave.	去 你 的 戴夫
You fucking asshole.	你 個 混蛋
I just have one more question for you.	我 還有 一個 問題 要問 你
Do you ever feel like a plastic bag? Drifting	你 可 曾 感到 自己 如同 空中 的 塑膠袋
through the wind? Wanting to start again? -What is that?	隨風 飄 蕩 想要 重新 開始 - 你 說 什麼
- I don't know what that is. -Oh, yes, you do.	- 我 不 知道 你 說 什麼 - 哦 你 知道 的
No, I don't. I never heard that before in my life.	不 我 不 知道 我 這輩子 都 沒 聽過
Do you ever feel? Feel so paper thin?	你 又 可 曾 感到 自己 單薄 得 如 紙般 脆弱
Just like a house of cards?	如同 紙牌 搭成 的 房子
One blow from caving in?	只要 輕輕 一 吹 就 會 崩塌
I don't know	我 不 知道
what you're singing.	你 唱 的 是 什麼
You know exactly what it is.	你 一定 知道 我 唱 的 什麼
- No, I don't. -You don't need to lie anymore.	- 不 我 不 知道 - 沒 必要 再撒謊 了
Katy Perry's your favorite!	凱蒂佩芮 是 你 的 最 愛
Katy who?	凱蒂什麼
I don't know who you're talking about.	我 不 知道 你 在 說些 什麼
You just got to ignite The light? And let It shine?	- 你 要 燃點 光芒 閃耀 全場
Not the chorus, please.	- 別唱 副歌 了 求 你 了
You just got to ignite And own The night -Stop! Like it's the Fourth of July?	- 你 要 擁有屬 於 你 的 夜晚 - 別唱 了 - 像 七月 四日 那樣 耀眼
Cause,Kimmy, you're a firework!Stop!	金別 忘 了 你 就是 一支 煙火 - 別唱 了
Go and show 'em what you're worth	來 吧 讓 他們 瞧瞧 你 的 價值
And make 'em go Oh, oh, oh	來 吧 現 在 就 點燃 自己 噢 噢 噢
As you sail across the sky-y-y	當你 在 天空 巡游 時人們 會 為 你 歡呼
Kimmy, you're a firework! No!	金 你 就是 那 創造 美麗 的 煙火 - 夠了
I don't need my father!	我 不 需要 我 父親
I am strong!	我 很 強大
Excuse me.	不好意思
Did you just shart?	你 剛剛 挫 屎 了 麼
No, I didn't.	不 我 沒 有
It was that camera guy.	是 那個 攝影師
It wasn't me.	不是 我
Ladies and gentlemen,	女士 們 先生 們
Kim Jong-un has just pooed	偉大 的 金 主席 剛剛 在 他 的 褲子裡
in his pants.	拉屎 了
Let's get the fuck out of here.	咱們 走 吧
Yeah, let's go.	好 咱們 走 吧
Damn, girl.	幹 神女
You a bad-ass.	妳 真是 個 壞 蛋
I thought you were my friend, Dave.	我 以 為 得 你 是 我 的 朋友 戴夫
I thought you were my friend, Kim.	我 也 以 為 你 是 我 的 朋友 金
I thought everyone lied about you.	關於 你 我 覺得 每個 人 都 撒謊 了
And then I saw that fake grapefruit	後 來 我 在 那個 假 的 食品 雜貨店
in that fake grocery store,	看到 假 的 柚子
and I realized that you were a fake friend.	我 意識 到 你 是 一個 假 的 的 朋友
And then you said you were gonna blow everybody up	然 後 你 說 你 會 把 所有人 都 炸死
just to show what a big guy you are?	僅僅 為 了 證明 你 是 個 大人物
No friend would blow up another friend's country.	沒有 哪個 朋友 會轟炸 另 一個 朋友 的 國家
You're just a flawed man	你 就是 一個 屁股 很大
with a big old butthole.	有 缺陷 的 人
And you pee and poo like the rest of us.	你 和 我們 一樣 會 拉屎 撒尿
Well, tell me this, Dave.	好 吧 這樣 說 吧 戴夫
Will you be so cocky	當我 在 全世界 面前 殺 了 你 時
when I slay you in front of the whole world,	你 還會 這麼 狂妄 嗎
you Yankee motherfucker?	你 個 他媽 的 美國 佬
If you shoot me,	如果 你 槍 殺 我
you'll just be proving me right.	你 將證明 我 是 對 的
You're just a sad little man.	你 只是 個 悲傷 的 小可 憐蟲
Dave! Dave! No!	戴夫 戴夫 哦 不
This is Dave Skylark	我 是 戴夫 • 史開勒
signing off.	直播 結束
Good-bye, Dave.	永別 了 戴夫
Oh, man.	天 哪
Bulletproof vest.	防彈 背心
Genius!	天材 啊 !
He's alive, everybody!	他 還活 著 啊 !
Oh, fuck!	幹嚇 屎 惹
Got a bulletproof vest on!	他 居然 穿 了 防彈 背心
I don't know how he got it, but he's got it on!	我 不 知道 他 怎麼 拿到 的 但是 他 就是 穿 上 了
Thank you for watching my interview with Kim Jong-un.	謝謝觀 看 我 對 金正恩 的 採訪
This is Dave Skylark	我 是 戴夫 • 史開勒
signing off.	直播 結束
No!	不
- Aaron! -Let's get the fuck out of here.	- 艾倫 - 我們 他媽 趕緊 離開 這個 鬼 地方
Wait!	等 一下
The puppy.	狗狗
Hey, what happened to your hand?	等 一下 你 的 手 怎麼 了
Someone bit my fucking fingers off.	某人 咬斷 了 我 的 手指
That's just like Frodo!	就 跟 佛羅多 一樣 !
- Oh, shit! -	幹完 了
Don't shoot! I have a puppy!	別開 槍 我 抱 著 一只 小狗
Go!	快 跑
- Oh, no! No!	哦 不 不
- What is that?! -Oh, oh, no!	- 那 是 啥 玩意 兒 - 哦 哦
- Oh, shit!	我 靠
Oh, God!	哦 天 啊
Oh, no!	哦 不
Oh, shit! Oh, shit! There's more!	靠媽 的 那裡 有 更 多 敵人
You're a hero!	你 是 一個 英雄 啊
Thank you, sir!	謝謝 你 同志
That's the only way out.	那 是 出去 唯一 的 路 啊
Hey...	嗨
I have an idea.	我 有 個 主意
Follow me.	跟 我 來
- Is this Katy fucking Perry?!	這他 媽是 凱蒂佩芮 的 歌 嗎
Just leave it on! It's helping me concentrate.	就 讓 它 開著 吧 能 幫 我 集中 注意力
Oh, shit, are those fucking nukes?	我操 那 他媽 是 核彈 嗎
Let me check!	讓 我 看看
Oh, we really fucked up!	操 我們 死定了
He's arming his fucking nukes!	他媽 的 他 要 發射 核彈
Aah! Fuck!	啊 靠 杯
Skylark!	史開勒
Kim!	金正恩
Fuck you!	幹 你 娘 !
I've been grazed!	我 被子 彈擦傷 了
- How's the puppy? -Puppy is okay!	- 小狗 怎樣 了 - 小狗 沒事
You protect that puppy with your life.	你 要 用 生命 保護 小狗
We got to do something!	我們 要 做點 什麼
He's gonna fucking kill us!	他 要 殺 了 我們
We're in a tank!	我們 在 坦克 裡
Shoot him back.	回擊 轟 了 他
It's loaded!	填裝 完畢
Let's barbeque this motherfucker.	我們 炸死 那狗 娘養 的
On three.	倒數 三秒
Balls to the wall, motherfuckers!	快點 啊 混帳 王八蛋
Boom, boom...	繃 繃
Boom!	繃 !
Yes!	耶 !
- Yes! Yes!	哦 耶 哦 耶
Yes!	哦 耶
Okay. -SOOK: Okay.	好 的 - 好 的
That way.	這條 路
It's an old mining tunnel.	是 個 破 舊 的 采礦 坑
- Holy shit, where does that go? -West.	- 我 去 這能 帶 我們 去 哪裡 - 西邊
Away from Pyongyang.	遠離 平壤
Keep moving until you reach the coast.	你們 要 一直 走到 海邊
I wish you both luck.	我祝 你 們 倆 好運
You sound like you're not coming with us.	怎麼 聽 起來 好像 你 不 跟 我們 一塊 兒 走
- Yeah, Sook....? -What-what are you doing?	- 對 啊 素英 - 你 要 干嘛
I have to go to Pyongyang.	我要 回 平壤
That's going right back into the snake pit.	你 要 直接 回到 那個 瘋人院 嗎
I can't leave North Korea.	我 不能 離開 北韓
I just helped plunge it into chaos.	我 剛剛 把 事情 變 的 更加 混亂
- Yeah, yeah. -So did we. I'm okay with leaving.	- 是 啊 - 我們 剛才 不 也 摻 和 了 一腳 嗎 但 我 很 高興 離開 啊
I have to ensure that the power	我要 確保政權
does not transfer to the wrong hands.	不會 落到 錯誤 的 人 手上
I can't deny	我 不 否認
that we have a chemistry,	我們 之間 有 感情
but I have to stay here for my people.	但 我 需要 待 在 我 的 人民 身邊
Okay.	好 吧
I'm glad to meet you.	很 高興遇 見 你
Okay.	嗯
Kiss her.	吻 她
Kiss her, dude.	親 她 啊 兄弟
Yeah, get in there.	對 就是 這樣
-Ooh...	哦
I'm happy to have met you, Aaron.	我 很 高興 認識 你 艾倫
You, too.	我 也 是
Bye, Sook.	再見 素英
Have fun with the war.	好好 在 戰爭 快樂
- All right, it's clear. -Okay.	- 沒人 很 安全 - 好 的
Okay, here you go.	好 我們 走
- You got him? -All right... got him.	- 你 抱住 它 了 - 是 的 抱住 了
Yeah.	好
You out of that big, old, scary hole?	你 從 那個 深邃 的 破 舊 又 可怕 的 洞穴 裡出 來 了 耶
Where are we?	我們 在 哪兒
I don't know.	不 清楚
Is this China?	這是 中國 嗎
I don't know. Looks like North Korea.	不太 清楚 看起 來 還在 北韓
Yeah.	好 吧
Man.	兄弟
- Well, which way's the coast? -I have no idea.	- 好 吧 哪 條路 通往 海岸 - 完全 沒頭緒
Does that do something?	那能 有點 什麼 作用 嗎
Dogs always run to the sea.	狗 總 向往 海邊 跑
- That's not true. -You got to find the sea.	- 這 不是 真的 - 你 得 自己 去 找到 海岸 線
I don't think that's gonna happen, Dave.	我覺 得 這個 不 可能 會 成功 的 戴夫
Shit.	該 死 的
- Shit! Shit! Shit! -Protect the puppy!	- 該 死 的 該 死 的 該 死 的 - 保護 好 小狗
- Protect the puppy! -Stop! It's them.	- 保護 好 它 - 停下 是 他們
Echo Romeo Five.	羅 密 歐五號 請 回答
Echo Romeo Five, we have contact	羅 密 歐五號 請 回答 我們 找到 了
with Dung Beetle and Aardvark.	糞金龜 和 食蟻 獸
Aaron, Dave, I'm Captain Sung,	艾倫 戴夫 我 是 宋隊 長
- SEAL Team Six. -Holy shit.	- 海豹 突擊六隊 - 哇勒靠
How'd you guys find us?	你們 怎麼 找到 我們 的
We tracked you using the GPS	我們 從 你 們 的 手 錶
- on your wristwatch. -Oh, my God.	- 的 GPS 訊號 追 蹤 你 們 - 噢 天 哪
Let's get you boys home.	讓 我們 帶 你 們 回家
Oh, my God.	天 哪
For you.	給你 的
Me?	給我 的
Is it the president?	是 總統 嗎
Mr. Obama?	奧巴馬
Nope, just me, Agent Lacey.	不是 我蕾絲 特工
Agent Lacey.	蕾 絲 特工
Fancy hearing from you here.	在 這兒 聽 到 你 的 聲 音感 覺真 好
I enjoyed your interview, guys.	我 很 喜歡 你 們 的 採訪
Now try not to fuck up your extraction.	現在 試著 不要 把 你 的 撤退 計劃 搞砸
Get home safe.	安全 的 回家吧
Guess who's going to America where they don't eat doggies?	猜猜 誰 會 去 美國 那個 不會 吃 狗狗 的 地方
- And you get all the good stuff, -Okay, let's just go.	- 你 會 被 照顧 的 很 好 - 好 的 我們 出發 吧
- and it's nice. -Let's get out... Can we please go? Okay.	- 太好了 - 我們 走 吧 我們 能 走 了 嗎 好 的
Get them in.	讓 他們 進來
Take the dog.	帶上 那 隻 狗
She honeypotted me	她色 誘 我
What? What are you talking about?	什麼 你 在 說 什麼
Sook.	素英
Think about it, man.	好好 想想 吧 老兄
I mean, she researched me, she seduced me,	我 的 意思 是 她 研究 過我 她 勾引 我
she commandeered my plans, made them her own.	她 把 我 的 計劃 據 為己 有 變成 她 自己 的
I mean, she used me.	我 的 意思 是 她 利用 我
I'll admit it was for, like, a really good fucking cause,	我承認 這個 是 個 他媽 的 好 理由
but she honeypotted me.	但是 她色 誘 我
Yeah.	是 的
Well, good riddance.	好 吧 離開 她 更好
I hated that fucking bitch.	我 討厭 那 他媽 的 婊子
Really?	真的 嗎
Nah, just thought it would make you feel better.	不 只是 覺得 這會 讓 你 感覺 好 一點
That was your one true love.	那 是 你 唯一 的 真 愛
Now she's gone.	現在 她 走 了
Doesn't make me feel any better.	沒有 讓 我 感覺 到 好點
Well, you have us,	但 你 有 我們
and "We wuv you."	我們 愛 你
"We aw wuv each other."	我們 互相 愛著 對方
"And as the North Korean coastline	隨著 北韓 海岸 線
"Receded in the distance,	漸漸 離 我們 遠 去
"We heard the crackling of gunfire.	我們 聽 到 噼裡 啪啦 的 槍聲
"It was the beginning of a revolution...	這是 一場 革命 的 開始
"A revolution Aaron and I started.	一場 艾倫 和 我 共同 挑起 的 革命
"Of course, in a tale like this.	當然 在 這樣 的 故事 裡
"You might expect to find	你 也 許會 期待 能 發現
"Some hot CIA	一些 火辣 的 ...
"Honeypot...	誘人 的
bombshell..."	中情局 超級 正妹
"...maybe a few drones	也 許幾架 無人機
or a secret CIA watch."	或者 一支 充滿 機密 的 CIA 手 錶
You got Skype!	妳有 Skype 了 !
So good to see your face.	很 高興 看到 你
Wait, someone else wants to say hi.	等會兒 有人 想 打個 招呼
ha ha	哈哈哈
Guess what we named him?	猜猜 我們 叫 他 什麼
Kim Jong-un.	金正恩
Aaron, that's a little fucked up, no?	艾倫 那 名字 有點爛 對 吧
Oh, it's super fucked up, but he's cute, though.	是 的 這 名字 非常 糟糕 但是 它 很 可 愛
"But there was none of that.	但是 什麼 都 沒 有
"No.	什麼 都 沒 有
"This was a revolution	這場 革命
"Ignited with nothing more	只是 因為 那
"Than a camera	一台 攝影機
"And some questions.	和 一些 問題 引起 的
"Questions that led a man	這些 問題 致使 一個 男人
"Once revered as a god	這個 曾經 被 平民 當做 神 一般 的 人
"Among mortals to cry	放聲 大哭
"And shit his pants.	在 褲子裡 挫賽
